FIPS_Code,Employed_2020,Median_Household_Income_2020,Unemployment_rate_2020,"Percent of adults completing some college or associate degree, 2019-23","Percent of adults who are high school graduates (or equivalent), 2019-23","Percent of adults who are not high school graduates, 2019-23","Percent of adults with a bachelor's degree or higher, 2019-23",BIRTHS_2020,DEATHS_2020,DOMESTIC_MIG_2020,GQ_ESTIMATES_BASE_2020,INTERNATIONAL_MIG_2020,NATURAL_CHG_2020,NET_MIG_2020,Anxiety_Score_2020,Depression_Score_2020,State_Name,Region
1001,24955,70148,5.3,29.32028356,32.67593887,9.721097947,28.28267962,162,176,100,484,0,-14,100,2.54537222,2.595786405,Alabama,South
1003,92639,71704,6.1,31.391725,27.54203782,8.268600135,32.79763704,560,602,1613,3549,11,-42,1624,2.548291406,2.606122089,Alabama,South
1015,43315,52772,7.7,31.05294619,34.48815292,13.91379552,20.54510537,305,397,-115,5632,0,-92,-115,2.575424673,2.618108304,Alabama,South
1017,14866,45563,7.4,30.58323803,38.45368404,16.3780428,14.58503512,87,167,-51,860,2,-80,-49,2.678848378,2.729827771,Alabama,South
1019,11060,52613,5.1,30.56398786,37.3595356,16.1314374,15.94503914,62,122,59,278,0,-60,59,2.825578143,2.507563884,Alabama,South
1021,18817,61823,5.4,27.70026344,41.23979575,15.81292484,15.24701597,147,143,26,388,1,4,27,2.82001128,2.85346441,Alabama,South
1031,20913,62429,4.8,35.41350531,29.08085844,13.97680468,21.52883156,159,174,91,764,1,-15,92,2.518974599,2.621968026,Alabama,South
1033,22125,54593,7.2,32.72243643,34.55512714,12.45058324,20.27185319,166,176,68,407,2,-10,70,2.582152983,2.604913674,Alabama,South
1039,14483,46958,5.4,32.17430742,36.83056805,13.8176046,17.17751994,88,157,3,778,0,-69,3,2.595205219,2.681044921,Alabama,South
1043,36947,61774,4.7,34.92628205,30.98237179,15.00480769,19.08653846,252,254,290,1262,0,-2,290,2.506608642,2.550847954,Alabama,South
1045,19769,50567,5.3,35.21518089,31.18053913,14.27642469,19.32785528,149,137,-78,757,-1,12,-79,2.630266818,2.901130699,Alabama,South
1047,13076,35258,11.6,31.01109499,39.04026346,12.94154546,17.00709609,101,162,-202,476,1,-61,-201,2.58204517,2.653866557,Alabama,South
1049,29685,50037,4.9,31.41713437,33.64765599,21.05480357,13.88040607,188,222,48,848,4,-34,52,2.566330618,2.572899884,Alabama,South
1051,35614,71463,5.2,30.72711415,34.46766587,10.41087926,24.39434072,213,245,-84,5795,0,-32,-84,2.489558424,2.560519694,Alabama,South
1053,13595,47792,6.7,26.84811169,43.19385074,17.46735166,12.49068591,93,132,-49,2067,0,-39,-49,2.738051659,2.704486581,Alabama,South
1055,37867,55487,8.3,34.33236875,33.96858206,14.22213036,17.47691884,289,362,58,1592,0,-73,58,2.61193406,2.643090671,Alabama,South
1069,44343,56842,5.9,32.54262317,32.08887099,12.60034904,22.7681568,312,316,54,822,0,-4,54,2.53253328,2.594497899,Alabama,South
1071,21700,51965,5.8,28.62496701,37.88070731,17.94404856,15.55027712,127,201,25,603,0,-74,25,2.561757284,2.576837989,Alabama,South
1073,298089,61996,6.7,29.16168969,25.89349154,9.008057757,35.93676101,1919,2031,343,17043,23,-112,366,2.56454508,2.604763537,Alabama,South
1077,39978,59023,6.1,28.61653139,33.60336357,10.69596957,27.08413547,220,305,607,3052,1,-85,608,2.608745854,2.639211652,Alabama,South
1081,72003,59637,5.7,28.29579067,21.79658703,8.574288965,41.33333333,460,324,299,5377,20,136,319,2.540470047,2.591010509,Alabama,South
1083,43673,83159,4.6,30.80403207,26.367172,12.43749504,30.3913009,289,214,575,3116,2,75,577,2.50903317,2.58103393,Alabama,South
1087,7318,36601,10.3,31.74684847,31.72112169,15.79624389,20.73578595,29,77,-17,2069,0,-48,-17,2.703350627,2.691068486,Alabama,South
1089,179653,80426,5.1,27.7264739,19.17419715,7.409038043,45.69029091,1076,844,2269,9764,9,232,2278,2.556972564,2.623264733,Alabama,South
1095,42649,53388,4.6,30.41494477,32.67939717,15.57924815,21.32640991,340,314,27,962,4,26,31,2.543720478,2.638430384,Alabama,South
1097,177944,54315,8.5,30.03839456,33.81968828,10.99169307,25.15022409,1288,1347,-457,7750,11,-59,-446,2.601774204,2.622273233,Alabama,South
1101,98928,56862,8.4,28.38616715,26.18361466,11.15619065,34.27402754,782,713,-652,8397,7,69,-645,2.592113796,2.613929336,Alabama,South
1103,56703,62260,4.9,30.38675332,31.45734667,14.91544545,23.24045456,343,382,-103,2287,1,-39,-102,2.554654635,2.596433351,Alabama,South
1109,14958,45144,5.4,26.30219099,33.9654816,12.41732121,27.3150062,89,100,-86,2143,2,-11,-84,2.568141391,2.592078795,Alabama,South
1113,22420,45074,5.7,37.88450486,31.05274994,14.21074989,16.8519953,184,166,34,530,8,18,42,2.598352783,2.594863398,Alabama,South
1115,39102,70361,5.3,32.97325418,34.66858437,12.41508048,19.94308097,233,265,207,2108,0,-32,207,2.564620698,2.622657889,Alabama,South
1117,112759,98263,4.2,27.35867221,20.45081125,5.991990142,46.19852639,537,444,762,3253,8,93,770,2.526650369,2.58207737,Alabama,South
1121,33565,55186,7.7,31.88067848,35.80681936,15.48865167,16.82385049,219,265,-444,3241,0,-46,-444,2.579410913,2.600613254,Alabama,South
1123,16802,55270,7.5,32.34869106,32.73515475,16.1911483,18.72500588,103,144,6,680,0,-41,6,2.547318606,2.578328623,Alabama,South
1125,96111,60875,7.2,30.64274098,28.85040865,9.129169371,31.377681,611,511,5189,11131,4,100,5193,2.564449046,2.591038862,Alabama,South
1127,23555,51065,6.4,32.55508276,34.32174126,17.12076993,16.00240604,165,309,-73,1081,1,-144,-72,2.624642027,2.637844176,Alabama,South
2020,135425,99162,7.9,31.83926855,24.48998675,5.991843944,37.67890075,966,482,-881,9077,46,484,-835,2.600064189,2.671540184,Alaska,West
2090,41534,84166,6.7,35.61030601,25.56243567,5.118695574,33.70856275,336,114,-519,3987,9,222,-510,2.583437915,2.668891649,Alaska,West
2110,15139,102097,7,32.86749934,21.32500655,5.349812211,40.45768189,70,46,-77,934,2,24,-75,2.55374256,2.692906388,Alaska,West
2122,24064,76254,9.6,34.29049279,30.62753227,5.691133515,29.39084142,149,111,94,1964,1,38,95,2.608490793,2.672864067,Alaska,West
2170,44112,86313,8.8,36.15230954,33.86055166,5.706819177,24.28031961,339,164,244,2350,0,175,244,2.567958565,2.665245364,Alaska,West
4003,46793,55254,6.9,36.39296878,25.16721003,10.78210601,27.65771519,319,361,97,5075,9,-42,106,2.622873402,2.700206988,Arizona,West
4005,65377,64016,9.6,30.93976894,21.41536143,8.025480616,39.61938901,335,289,-13,12049,-4,46,-17,2.616126725,2.676673045,Arizona,West
4007,18884,51928,7.6,39.34659091,31.43939394,10.36682616,18.847189,110,213,206,843,1,-103,207,2.486669887,2.558483227,Arizona,West
4009,14506,63797,6.2,39.33804238,30.30877901,15.76185671,14.5913219,107,76,64,2663,0,31,64,2.701400846,2.750028619,Arizona,West
4013,2100745,83668,7.3,31.67995468,21.95833968,10.50369985,35.8580058,11597,9639,18682,74597,135,1958,18817,2.607169592,2.655375549,Arizona,West
4015,77778,54842,9.9,38.61283888,34.66781545,11.83389002,14.88545564,400,1016,1733,4322,2,-616,1735,2.61455616,2.686322928,Arizona,West
4017,35406,49948,10,38.28350207,30.07840243,14.00660084,17.63149466,318,435,157,2038,0,-117,157,2.636511492,2.65837448,Arizona,West
4019,444682,64007,7.6,32.89714048,21.1780955,10.05413659,35.87062743,2351,2994,2257,27486,66,-643,2323,2.609143808,2.676009107,Arizona,West
4021,174818,76232,7.4,36.63589679,30.33993888,10.87394852,22.15021581,1069,1055,4607,23521,14,14,4621,2.63866499,2.709603674,Arizona,West
4023,16724,53467,11.3,27.26430465,26.37295933,22.29321747,24.06951855,148,94,-19,114,4,54,-15,2.597474054,2.630385316,Arizona,West
4025,96224,64187,7.4,38.11079237,24.78378679,7.503168299,29.60225254,406,871,1670,4062,1,-465,1671,2.59152329,2.687105787,Arizona,West
4027,78941,54209,17.1,33.23556275,26.7299824,23.36246649,16.67198836,646,572,560,8505,24,74,584,2.630594834,2.624921765,Arizona,West
5005,15297,48573,6.1,36.00460242,34.64875455,10.59800355,18.74863949,77,196,198,522,0,-119,198,2.477595173,2.651873282,Arkansas,South
5007,135231,86374,4.5,25.83238661,28.1348474,9.425232996,36.60753299,916,491,1954,3026,34,425,1988,2.572907353,2.623539815,Arkansas,South
5019,8550,50519,6.1,31.76860305,32.70582532,10.03474186,25.49082976,60,68,-50,2857,0,-8,-50,2.577496918,2.576909481,Arkansas,South
5027,8282,47278,7,27.48828624,40.59349709,11.53627715,20.38193951,57,79,-36,2012,0,-22,-36,2.671190018,2.667190185,Arkansas,South
5031,52654,60580,5.4,30.12605979,32.36139,9.745928157,27.76662204,356,264,272,3951,4,92,276,2.55250155,2.585328685,Arkansas,South
5033,24751,54741,5.5,31.02964986,36.29992992,13.36780804,19.30261218,172,168,2,673,2,4,4,2.584101957,2.621160483,Arkansas,South
5035,18983,49644,8.5,30.32891927,37.76492623,14.7110045,17.19515,156,156,-85,495,0,0,-85,2.665468085,2.681246007,Arkansas,South
5045,57714,63429,5.6,30.08667941,30.40025494,6.31612492,33.19694073,379,250,153,4738,3,129,156,2.580683866,2.61977528,Arkansas,South
5051,37708,53239,8.1,33.7488344,30.89929241,9.105369974,26.24650321,230,353,204,1650,2,-123,206,2.591511957,2.65430684,Arkansas,South
5055,18110,54475,6.1,28.31620401,42.59277047,12.60205552,16.48897,151,115,82,849,0,36,82,2.586528906,2.529539707,Arkansas,South
5063,15479,57611,5.9,31.21476166,39.40779876,12.50640697,16.87103261,109,103,-9,850,0,6,-9,2.563488516,2.613399532,Arkansas,South
5069,24662,45894,8.2,26.82818305,41.09768849,11.43295735,20.64117111,198,257,-339,5589,2,-59,-337,2.632498977,2.609577302,Arkansas,South
5071,9323,46660,6.4,24.63625866,41.18937644,16.09699769,18.07736721,76,71,-33,454,0,5,-33,2.677065618,2.767470059,Arkansas,South
5085,31393,66160,5.6,32.19748961,37.0193551,9.788943924,20.99421137,175,194,34,720,0,-19,34,2.604677293,2.651627985,Arkansas,South
5091,17671,48652,7,30.44231235,40.42811125,13.08233175,16.04724464,132,139,-16,1375,0,-7,-16,2.549889418,2.611387409,Arkansas,South
5093,15414,45168,9.2,28.96594284,42.46538358,14.39040383,14.17826976,139,135,-141,778,0,4,-141,2.593554557,2.580373471,Arkansas,South
5105,3839,56640,5.7,30.35368886,44.21110804,8.303398729,17.13180437,23,37,-9,90,0,-14,-9,2.863303554,2.414702262,Arkansas,South
5113,7330,45289,6.8,34.35215947,35.82871908,12.61720192,17.20191953,52,65,-25,96,0,-13,-25,2.596763201,2.527973794,Arkansas,South
5115,25735,57881,6,26.33975904,35.00240964,14.02168675,24.63614458,175,182,10,2770,0,-7,10,2.597111024,2.625887797,Arkansas,South
5119,172305,57057,7.6,29.47393325,25.12670183,8.038311825,37.36105309,1188,1085,-116,8904,17,103,-99,2.577895815,2.607439831,Arkansas,South
5125,54956,70330,5.1,31.40489227,32.74561796,7.349885786,28.49960398,332,295,352,1289,1,37,353,2.521373382,2.578711793,Arkansas,South
5131,52065,52679,6.1,30.54620342,30.25002025,14.82072819,24.38304814,373,336,-66,1810,4,37,-62,2.556501345,2.628386369,Arkansas,South
5139,14046,50258,8.5,28.94756926,40.09005571,12.04304358,18.91933145,99,149,-71,618,0,-50,-71,2.556592711,2.539725046,Arkansas,South
5143,119568,62100,4.7,24.3433323,28.30535696,12.73702207,34.61428867,741,467,591,9553,17,274,608,2.519536627,2.572501142,Arkansas,South
5145,31311,56866,6.4,26.33593029,40.60874855,13.25235002,19.80297113,200,225,33,2668,2,-25,35,2.556461321,2.608268213,Arkansas,South
6001,745114,121190,8.9,21.56816276,15.86231471,11.10015783,51.4693647,4368,2755,-3845,53905,160,1613,-3685,2.585382779,2.607242056,California,West
6007,84510,63353,9.4,36.34895703,22.25753417,9.672944527,31.72056427,488,514,-1307,4958,1,-26,-1306,2.618262087,2.683630677,California,West
6013,497173,119667,9,26.99559056,17.70679714,10.38745333,44.91015897,2939,2151,-1000,11277,131,788,-869,2.597261913,2.590652124,California,West
6017,83202,104859,8.5,35.3601444,20.7322748,5.083479046,38.82410175,395,408,31,1261,0,-13,31,2.604987181,2.684999146,California,West
6019,393753,68693,11.6,31.72635598,23.01607294,21.40307517,23.85449591,3319,1874,-827,18411,4,1445,-823,2.671262936,2.691323734,California,West
6021,11612,63247,9,32.41705143,31.42381617,19.67679588,16.48233652,92,55,-53,278,0,37,-53,2.623083979,2.666589821,California,West
6023,54656,57660,8.5,36.19551848,23.23760629,8.481736991,32.08513824,298,335,-182,4514,0,-37,-182,2.605753955,2.680962273,California,West
6025,55364,55523,22.6,29.86109855,25.88576803,28.15286394,16.10026948,536,432,-233,8487,7,104,-226,2.663781881,2.673370873,California,West
6029,336819,65981,12.8,30.88688463,27.67452265,22.86501673,18.57357599,2944,1721,-3897,28724,-17,1223,-3914,2.668039936,2.700594828,California,West
6031,50252,63683,11.8,32.22774609,28.08833534,25.76482286,13.91909571,559,249,-12,15491,2,310,-10,2.655910223,2.669238886,California,West
6033,25682,51848,9.8,40.50270767,28.83825483,12.91509145,17.74394605,168,185,49,689,0,-17,49,2.634916576,2.779466783,California,West
6037,4363337,82455,12.3,24.8941944,20.2979643,19.33684888,35.47099242,23767,19922,-25491,208714,156,3845,-25335,2.63295771,2.65654781,California,West
6039,55065,71273,11.1,32.0242475,23.89455528,26.95241229,17.12878493,486,283,-120,7204,0,203,-120,2.691347757,2.685959526,California,West
6041,121786,135960,6.8,21.49479082,10.78056151,7.265481461,60.45916621,507,529,-879,7753,3,-22,-876,2.638517223,2.433775014,California,West
6045,33785,63621,9.1,35.11067479,26.12783973,13.8377997,24.92368578,219,232,-199,1609,0,-13,-199,2.619430654,2.674766838,California,West
6047,101032,65253,12.5,28.42622721,28.68280793,28.11074957,14.78021529,906,528,123,5018,3,378,126,2.661091535,2.686138649,California,West
6051,6932,79105,12.1,37.62694301,17.60621762,10.44559585,34.32124352,44,7,-14,306,1,37,-13,2.446964994,2.583880309,California,West
6053,190346,91450,11.1,24.81541425,20.63564814,26.66521051,27.88372709,1456,693,-1401,17837,8,763,-1393,2.658132851,2.677007422,California,West
6055,62735,98580,8.9,28.73963838,17.4504533,15.29278289,38.51712542,299,330,-474,5145,0,-31,-474,2.617046071,2.658535034,California,West
6057,42981,80069,8.1,35.13953576,20.46903202,4.931399649,39.46003256,205,271,117,1949,0,-66,117,2.574814766,2.645073595,California,West
6059,1424333,106047,8.9,26.3383016,17.20472336,13.05593737,43.40103767,7632,5294,-4224,53489,77,2338,-4147,2.635129669,2.679143986,California,West
6061,173074,106114,7.4,34.88348208,17.15057463,5.075299297,42.89064399,888,831,1075,4451,2,57,1077,2.565127822,2.64226234,California,West
6065,1006179,86350,10.1,31.88037533,26.33554689,16.70006009,25.08401769,6377,4826,2407,35672,27,1551,2434,2.661989595,2.682089959,California,West
6067,643643,83985,9.4,33.15417066,21.92956635,11.63248072,33.28378227,4497,3077,-663,34212,177,1420,-486,2.612424388,2.650591328,California,West
6069,29328,106560,9.9,34.54775604,26.30379747,16.76179517,22.38665132,170,102,251,445,0,68,251,2.69516107,2.700052739,California,West
6071,879264,78779,9.6,31.36297388,27.82988533,17.90570045,22.90144034,6513,4013,-1347,42209,12,2500,-1335,2.683481684,2.702998396,California,West
6073,1399329,98365,9.4,28.98126379,17.94657436,10.98229061,42.08987125,9170,5945,-6905,115152,161,3225,-6744,2.617764401,2.66882738,California,West
6075,514683,135366,7.9,17.35406537,11.32272824,11.20244218,60.12076421,2098,1601,-3744,27872,84,497,-3660,2.554870559,2.638455283,California,West
6077,296348,84738,11.5,31.1032099,27.75445929,19.56937278,21.57295804,2394,1502,175,18089,35,892,210,2.664382293,2.686333931,California,West
6079,123695,88578,7.8,34.38993235,18.17875973,8.229907534,39.20140039,608,609,-515,16285,0,-1,-515,2.594274643,2.66032119,California,West
6081,408287,143795,6.9,22.41872916,14.81497847,9.695058298,53.07123407,1890,1319,-2538,9360,101,571,-2437,2.549391701,2.562665278,California,West
6083,200743,89334,8.1,29.36083259,16.90536386,17.86386359,35.86993995,1328,819,-445,20708,22,509,-423,2.603476754,2.659292575,California,West
6085,950754,150502,7.1,19.9518602,13.50843605,10.6740767,55.86562705,4882,2763,-7099,39638,191,2119,-6908,2.580242731,2.571839863,California,West
6087,121753,99256,9.7,29.72836098,15.20699884,11.5066755,43.55796468,552,404,-556,14565,4,148,-552,2.596145776,2.646392669,California,West
6089,66741,66312,8.9,42.4345089,26.36854877,7.930256537,23.26668579,460,563,-92,3023,1,-103,-91,2.57730691,2.648945115,California,West
6093,15269,51593,10,41.97246994,26.01684119,8.9270733,23.08361557,92,139,-37,554,0,-47,-37,2.513293725,2.629082307,California,West
6095,182148,92711,9.7,36.23180559,24.32111348,11.08003949,28.36704144,1209,950,-991,11123,0,259,-991,2.638715304,2.685047423,California,West
6097,225996,96312,8,32.36829978,18.64851951,11.13624219,37.84693852,1151,1076,-668,8841,5,75,-663,2.578752783,2.651361329,California,West
6099,215474,75249,11,31.62868528,29.34753322,19.8868358,19.1369457,1761,1051,-466,6513,6,710,-460,2.648636662,2.694177823,California,West
6101,40347,66071,11.4,33.9569161,24.67058896,21.16504259,20.20745235,295,225,-225,983,3,70,-222,2.630725537,2.637133537,California,West
6103,23343,58900,9.1,38.66337295,28.77331197,13.72012285,18.84319224,171,175,-136,803,0,-4,-136,2.680151446,2.719301918,California,West
6107,175249,64313,13.4,31.55782036,26.97089315,25.63179558,15.83949091,1600,919,-46,5245,0,681,-46,2.704586515,2.724437892,California,West
6109,18045,70108,10.6,44.45160059,25.12284719,6.481083918,23.9444683,105,193,-132,3742,0,-88,-132,2.618477915,2.658409185,California,West
6111,374275,101981,8.7,30.16572235,19.45706992,14.71144733,35.6657604,2023,1533,-1078,12157,-1,490,-1079,2.657346469,2.67831351,California,West
6113,96690,82359,7.8,26.78712609,17.54081625,11.58820685,44.08385081,503,378,-297,8630,15,125,-282,2.597813343,2.65694715,California,West
6115,27444,63626,10.6,39.66904681,27.09584797,15.3386981,17.89640712,286,148,233,2402,2,138,235,2.663738596,2.695116213,California,West
8001,249638,89849,7.5,28.41301592,28.55024597,15.01418819,28.02254992,1643,965,53,4470,36,678,89,2.61507162,2.694502795,Colorado,West
8005,333007,93525,7.3,27.43030006,18.79163932,8.035629448,45.74243117,1904,1484,-536,5397,89,420,-447,2.543979231,2.646667249,Colorado,West
8013,179548,96584,5.7,20.59604765,11.02094838,4.474008489,63.90899548,623,571,-23,15316,23,52,0,2.542496351,2.63967973,Colorado,West
8014,37893,114746,6.1,24.82277484,12.61017966,3.923333708,58.64371179,150,149,409,482,1,1,410,2.531706944,2.627032039,Colorado,West
8031,387125,87619,7.6,20.95429257,14.75479323,8.644249174,55.64666503,2139,1589,1558,15932,49,550,1607,2.594172322,2.661491974,Colorado,West
8035,185433,140768,5.3,25.49391371,11.56116564,2.011105092,60.93381556,924,525,1984,1643,19,399,2003,2.51841577,2.600605791,Colorado,West
8037,32191,105813,8.9,25.17095409,17.72662375,6.833153821,50.26926834,126,40,-149,99,5,86,-144,2.487094975,2.542998935,Colorado,West
8041,318334,82248,6.7,34.35159994,19.63201026,4.894337544,41.12205226,2203,1331,974,20495,-13,872,961,2.603825601,2.679015058,Colorado,West
8045,29365,86566,6.3,30.53197646,24.50323141,11.55589852,33.4088936,180,84,-12,1068,3,96,-9,2.443077613,2.55328059,Colorado,West
8059,305322,102413,6.6,26.19994988,18.52940419,4.524621953,50.74602398,1460,1336,-75,8797,11,124,-64,2.617532079,2.658985357,Colorado,West
8067,28885,79358,6.4,28.13257288,21.01192079,3.595819156,47.25968717,119,103,1,1743,0,16,1,2.681218461,2.670544854,Colorado,West
8069,189141,88338,5.9,28.0879705,16.81644238,3.357546276,51.73804084,790,652,656,11706,3,138,659,2.569289252,2.647411086,Colorado,West
8077,69397,69578,7,33.25683739,28.46729123,7.648694619,30.62717676,395,425,334,3956,1,-30,335,2.563470841,2.659328168,Colorado,West
8097,10013,111291,9.8,21.82578189,11.2040009,3.000671792,63.96954542,38,16,-27,49,1,22,-26,2.560622036,2.616307149,Colorado,West
8101,70203,58314,7.6,35.40670671,30.03300611,9.542848393,25.01743879,396,518,250,3580,0,-122,250,2.582369603,2.653271516,Colorado,West
8107,14723,104407,7.4,26.68854542,17.71120051,3.477662503,52.12259157,61,42,-19,350,0,19,-19,2.599556763,2.688397243,Colorado,West
8117,19904,96984,9.2,25.41730841,17.04616409,5.070141115,52.46638638,64,24,-95,578,1,40,-94,2.564941962,2.651700792,Colorado,West
8123,153885,90770,6.5,32.04772263,24.45336503,11.54268799,31.95622435,1126,593,2057,5202,9,533,2066,2.597794621,2.650854117,Colorado,West
10001,73234,71866,8.3,29.80687419,33.65012602,9.804787208,26.73821258,522,516,422,4072,9,6,431,2.588516524,2.640991011,Delaware,South
10003,277563,85427,7.4,26.04737757,27.3227732,7.408736322,39.2211129,1513,1556,-9,15883,47,-43,38,2.554847538,2.616786272,Delaware,South
10005,99528,81188,7.2,27.51271908,29.56325374,10.35784259,32.5661846,544,887,1782,2763,6,-343,1788,2.589387229,2.641316638,Delaware,South
11001,355694,99897,7.9,14.7659195,14.51716122,7.153297028,63.56362225,2187,2004,-15475,40699,50,183,-15425,2.575732556,2.626554818,District of Columbia,South
12001,126615,58783,5.7,26.73337018,19.82315814,5.77353771,47.66993398,597,540,1279,17636,15,57,1294,2.544786249,2.589324704,Florida,South
12005,77333,65521,6.3,34.87021042,27.8548699,9.233590421,28.04132925,424,471,-616,3064,4,-47,-612,2.574159076,2.616695633,Florida,South
12009,261234,74899,7,33.51059362,26.08569232,6.863828348,33.53988572,1162,1924,3160,8007,15,-762,3175,2.584954573,2.65032217,Florida,South
12011,922908,70834,9.4,27.77412072,26.7054546,9.721509355,35.79891533,4890,4277,-2367,14950,383,613,-1984,2.59881595,2.635392001,Florida,South
12015,65747,65040,7.7,33.98364371,32.95213814,7.753842743,25.31037541,255,784,1965,3906,1,-529,1966,2.579253926,2.655896359,Florida,South
12017,42339,52534,8.9,32.51743287,37.96895213,9.113211119,20.40040387,256,763,1399,2841,0,-507,1399,2.607962077,2.700192869,Florida,South
12019,98484,84364,5.7,36.98347374,27.64955556,6.672429141,28.69454156,513,526,679,2456,7,-13,686,2.559606879,2.612959578,Florida,South
12021,163099,81821,7.3,25.06330296,25.37689867,10.01838205,39.54141632,743,962,1930,4834,53,-219,1983,2.566299684,2.624973547,Florida,South
12023,27530,54060,6.3,33.63054227,35.5130907,14.51122639,16.34514063,196,189,40,3638,0,7,40,2.596359064,2.681002814,Florida,South
12031,444744,70203,7.2,30.24933436,27.66459129,8.995269751,33.0908046,2968,2309,1341,22929,89,659,1430,2.577509922,2.630462235,Florida,South
12033,133076,61634,7.1,34.27585894,27.28815867,9.506195253,28.92978714,921,980,697,18744,13,-59,710,2.559421062,2.622407029,Florida,South
12035,43252,73336,7.9,32.77005552,29.8777387,6.912955037,30.43925075,152,418,1041,781,2,-266,1043,2.543421904,2.638445942,Florida,South
12039,16836,45628,7.3,25.34157024,35.86324116,18.71281951,20.08236909,109,147,-317,2051,1,-38,-316,2.647104394,2.715305092,Florida,South
12051,13903,55308,8.8,22.93105422,35.84264947,30.49715746,10.72913885,121,94,62,2257,4,27,66,2.81876756,2.613863538,Florida,South
12053,65713,60582,8.4,36.68719057,32.93125046,9.943597935,20.43796104,383,746,1647,2104,3,-363,1650,2.609882282,2.660227088,Florida,South
12055,31715,51954,8.2,32.18336543,34.45307162,13.63562954,19.72793341,183,439,404,1412,6,-256,410,2.534223487,2.617068523,Florida,South
12057,695452,74091,7.6,27.01310634,25.41487872,10.41679212,37.15522282,3982,3021,5444,30530,273,961,5717,2.595590992,2.632765453,Florida,South
12061,59012,69462,7.8,30.82006772,27.73440237,8.01229907,33.43323084,278,599,1097,1440,6,-321,1103,2.631812928,2.663296026,Florida,South
12063,16102,50625,5.8,29.90597948,38.66594049,16.78323683,14.6448432,114,163,-145,6494,0,-49,-145,2.531767712,2.628706556,Florida,South
12069,141967,67637,9.2,33.18276815,30.95968449,9.075035394,26.78251197,806,1183,2904,4841,21,-377,2925,2.586257011,2.647039866,Florida,South
12071,317679,71607,7.7,29.64626624,29.97411542,9.620298314,30.75932003,1644,2069,5743,13146,84,-425,5827,2.560491873,2.619501422,Florida,South
12073,141101,61560,6.2,26.3085104,18.81929234,6.289656107,48.58254115,727,541,1706,14924,3,186,1709,2.581478113,2.615014142,Florida,South
12081,162762,72176,7.2,28.50771533,28.19517174,8.953137481,34.34397545,826,1226,2548,6260,14,-400,2562,2.568204173,2.638800008,Florida,South
12083,128309,54517,7.4,32.45986128,34.7790643,10.3852903,22.37578412,817,1350,2296,9714,14,-533,2310,2.56450926,2.643328559,Florida,South
12085,66660,80678,6.4,32.25169866,23.83259665,7.278371852,36.63733284,303,539,506,4794,2,-236,508,2.549355089,2.632662414,Florida,South
12086,1170373,66952,8.2,23.19828301,26.65126766,16.9442348,33.20621452,6613,6052,-7286,38741,739,561,-6547,2.603710349,2.631477547,Florida,South
12087,40716,79459,8.2,27.80353184,27.65314191,6.742740198,37.80058606,170,193,0,1011,0,-23,0,2.572523222,2.632741674,Florida,South
12089,39025,90808,5.9,30.50519975,27.29158379,7.685969199,34.51724726,200,244,800,733,-1,-44,799,2.60937517,2.679028444,Florida,South
12091,89575,76663,5.8,35.00142205,24.19383236,6.583420236,34.22132535,640,470,184,4359,18,170,202,2.595902931,2.655660956,Florida,South
12093,16085,50176,5.7,28.66264262,35.22207878,20.01325843,16.10202017,149,122,-21,2624,1,27,-20,2.631334368,2.69935335,Florida,South
12095,656635,72129,11.2,27.77139771,23.84763923,9.97253797,38.40842509,3770,2201,-850,36633,437,1569,-413,2.609200452,2.652224356,Florida,South
12097,162790,63782,14.1,31.96042144,28.38845625,11.395694,28.25542831,1077,665,1985,2891,155,412,2140,2.614971247,2.664012427,Florida,South
12099,656392,76713,8,26.82502699,22.75566751,10.86766823,39.55163728,3324,4269,2717,27355,268,-945,2985,2.590765532,2.624703312,Florida,South
12101,222125,65933,7.5,30.24380189,32.93386804,8.785347525,28.03698255,1169,1708,5311,7958,7,-539,5318,2.589328363,2.641145579,Florida,South
12103,440021,66427,7.5,30.71066769,26.00479948,7.43959585,35.84493698,1752,3194,2219,20387,27,-1442,2246,2.565741324,2.633331803,Florida,South
12105,288372,61941,9.6,31.63118282,33.24663014,12.48127856,22.64090849,1854,2000,5696,15449,88,-146,5784,2.580253402,2.625807654,Florida,South
12107,24104,46459,8.4,27.48111733,40.63777288,17.78644215,14.09466765,188,273,133,1270,0,-85,133,2.583199645,2.605781498,Florida,South
12109,129978,103757,5.4,27.12061308,19.40307784,4.866306837,48.61000225,504,558,4142,3706,2,-54,4144,2.553400276,2.622537253,Florida,South
12111,134632,64038,8.1,32.5158839,30.74067067,11.37374072,25.36970471,719,944,2681,2917,12,-225,2693,2.594634339,2.655360718,Florida,South
12113,78203,82537,5.5,35.30479327,26.34979876,7.365532382,30.97987559,460,381,940,6197,10,79,950,2.558171601,2.627403124,Florida,South
12115,170379,78309,7.2,28.82361421,25.88791679,5.630772984,39.65769602,674,1662,3686,7960,0,-988,3686,2.625522937,2.658622613,Florida,South
12117,219044,80296,7.6,30.34603651,21.1544601,6.114612401,42.38489098,1136,932,179,4935,37,204,216,2.583749263,2.642069773,Florida,South
12119,29868,77851,8.3,29.6137755,28.48547014,6.834445216,35.06630914,105,573,1176,8542,2,-468,1178,2.551525222,2.655788309,Florida,South
12127,228207,64601,8,34.05557405,30.69959839,8.059866413,27.18496115,1100,1984,3449,16753,22,-884,3471,2.562531139,2.621515571,Florida,South
12131,30313,78814,6.1,29.35845701,27.81957458,8.592093564,34.22987484,197,199,708,2355,0,-2,708,2.68846386,2.769964396,Florida,South
13009,16463,49883,6.9,27.42557683,33.659655,14.78637455,24.12839362,98,148,37,5254,0,-50,37,2.522237023,2.613610003,Georgia,South
13013,38816,77583,5,32.44600703,34.15195968,12.37984724,21.02218604,241,181,438,450,0,60,438,2.495381084,2.605586683,Georgia,South
13015,46962,80017,6.2,28.84124621,36.86665958,11.35360732,22.93848689,309,317,436,1025,1,-8,437,2.571214147,2.654712608,Georgia,South
13021,62261,48539,7.4,30.25978424,31.15766049,12.59542354,25.98713173,495,476,-360,6179,0,19,-360,2.622156491,2.630722375,Georgia,South
13029,18132,93057,5.1,33.12442522,25.07919207,7.159644402,34.63673831,141,82,240,174,4,59,244,2.521382371,2.665250751,Georgia,South
13031,34790,49471,6.5,30.18321666,28.63624579,10.37939677,30.80114078,216,158,205,5839,0,58,205,2.612469908,2.63379721,Georgia,South
13039,20112,67628,4.8,38.16202811,31.88757233,7.517222375,22.43317718,170,99,78,2202,1,71,79,2.605142717,2.674292027,Georgia,South
13045,51291,69924,6.3,29.15978543,33.15538144,15.2539335,22.43089962,395,320,250,3352,0,75,250,2.60124886,2.647114109,Georgia,South
13047,31202,66918,4.4,34.56187403,30.784059,10.18312869,24.47093827,169,192,143,377,0,-23,143,2.540535635,2.618509873,Georgia,South
13051,129191,64029,7.6,29.86738985,24.61634106,8.762354185,36.75391491,853,705,-439,13974,23,148,-416,2.628632905,2.654207002,Georgia,South
13057,128714,99932,4.8,29.73392685,22.9557892,7.857215034,39.45306891,692,451,1363,2244,7,241,1370,2.523453107,2.586939107,Georgia,South
13059,54328,49832,6.4,23.5301247,17.76374263,10.03528239,48.67085028,319,206,-258,10084,2,113,-256,2.558810872,2.612991093,Georgia,South
13063,124510,57625,10.3,30.87966893,32.57905348,15.19842954,21.34284805,1004,567,-493,4999,9,437,-484,2.628935873,2.647589834,Georgia,South
13067,388183,96798,5.9,24.7338704,17.67597014,7.207410194,50.38274926,2064,1359,-745,9755,77,705,-668,2.575186732,2.627643849,Georgia,South
13069,17857,48792,5.8,26.32109932,39.81562011,20.35484432,13.50843625,126,135,-36,3096,0,-9,-36,2.536995342,2.615832568,Georgia,South
13071,20901,49214,4.5,27.15308626,36.86932308,20.28111118,15.69647948,148,143,-20,866,2,5,-18,2.705347804,2.660734921,Georgia,South
13073,72222,94224,4.2,33.12059057,22.13054245,6.913049572,37.83581741,448,296,686,1237,13,152,699,2.576494626,2.611199163,Georgia,South
13077,69922,87618,6.1,31.50146056,25.69814995,8.142161636,34.65822785,380,306,505,855,6,74,511,2.566394304,2.619220985,Georgia,South
13087,10786,46455,4.8,34.94013212,33.56213873,16.86106524,14.63666391,59,98,-10,817,0,-39,-10,2.570408266,2.559905149,Georgia,South
13089,362554,76736,7.9,23.99740538,20.06279909,9.192164847,46.74763068,2506,1441,-1407,10897,150,1065,-1257,2.600573062,2.635974885,Georgia,South
13091,6512,43783,6,28.76368454,42.05425005,13.94602887,15.23603654,40,64,-31,1761,0,-24,-31,2.673335852,2.329247343,Georgia,South
13095,34272,42629,8.6,31.26924829,30.84829157,14.64419134,23.23826879,268,383,-471,3230,1,-115,-470,2.582279216,2.603492816,Georgia,South
13097,67134,79242,7.3,30.12930265,30.4664769,8.599518923,30.80470153,390,302,200,887,1,88,201,2.565389654,2.613343047,Georgia,South
13103,30335,88111,4.9,31.32710111,32.62862446,9.246474569,26.79779986,194,110,314,313,1,84,315,2.610222593,2.582359528,Georgia,South
13111,10614,60604,4.7,30.81691831,34.87151285,11.71382862,22.59774023,37,86,188,131,0,-49,188,2.673463352,2.769506289,Georgia,South
13113,53605,109358,5.4,27.1894511,19.69481474,5.02494998,48.09078418,214,266,337,587,1,-52,338,2.559655371,2.610100661,Georgia,South
13115,40465,56651,6.2,29.26518348,30.70841048,15.08028045,24.9461256,260,293,4,4431,3,-33,7,2.558796699,2.588768014,Georgia,South
13117,117533,130909,4.5,22.94617233,14.51037122,5.940409249,56.6030472,556,340,1410,1284,12,216,1422,2.55354497,2.63001883,Georgia,South
13121,514890,89798,7.9,20.22346006,15.41538778,6.366013284,57.99513888,2800,2024,1669,34137,135,776,1804,2.626991893,2.644233656,Georgia,South
13127,35744,63532,6.7,30.7885352,28.41104213,10.3586052,30.44181746,184,252,37,2323,0,-68,37,2.579751626,2.611170258,Georgia,South
13129,26595,63946,5.4,27.24457425,34.5888514,20.51462813,17.65194622,147,155,182,489,3,-8,185,2.571085702,2.66226438,Georgia,South
13131,10166,48548,4.4,29.46676489,35.60945203,19.62939876,15.29438431,74,66,-22,183,0,8,-22,2.694241152,2.729877783,Georgia,South
13135,450320,83918,6.3,26.41655445,22.78521336,12.0699336,38.72829859,2647,1361,-599,6130,186,1286,-413,2.580428337,2.635280824,Georgia,South
13139,97607,76789,4.7,26.89869091,27.70688948,18.66269404,26.73172557,613,475,417,2606,4,138,421,2.572622853,2.614888135,Georgia,South
13151,108034,82379,7.3,34.12358653,30.28069694,7.559097377,28.03661916,574,475,1020,689,1,99,1021,2.614179754,2.659010194,Georgia,South
13153,66854,71237,5.2,33.77347845,27.17130169,6.797830518,32.25738934,465,359,595,1548,2,106,597,2.615413861,2.638377942,Georgia,South
13157,38345,82138,4.3,28.66926872,31.5929008,12.42911849,27.30871198,206,191,877,612,0,15,877,2.571289349,2.58330892,Georgia,South
13175,18011,47918,6.6,28.12003478,40.15948676,13.90712594,17.81335252,139,179,-8,928,1,-40,-7,2.669619437,2.617542921,Georgia,South
13179,24125,59807,6.2,40.40516416,31.73527205,7.976507723,19.88305607,336,99,-216,3141,11,237,-205,2.65121138,2.682275524,Georgia,South
13185,48417,52623,6,31.51226235,31.18461019,10.17831027,27.12481719,364,237,-2,5455,4,127,2,2.62409702,2.642469585,Georgia,South
13187,15780,71486,4.8,27.11111111,30.47953216,10.91461988,31.49473684,74,61,145,4048,1,13,146,2.491313603,2.522367875,Georgia,South
13207,12261,76428,5,26.83506686,35.27984151,9.202575532,28.6825161,69,98,131,1297,0,-29,131,2.481016459,2.407052233,Georgia,South
13211,8737,74340,5.3,22.31118952,38.84101242,8.712763792,30.13503427,54,49,104,177,0,5,104,2.758674915,2.726851018,Georgia,South
13215,71264,53740,7.8,32.4310483,26.79467387,11.03598254,29.73829528,665,561,-126,6283,28,104,-98,2.606119004,2.63296094,Georgia,South
13217,48479,72128,7.1,34.22929749,31.71073157,10.48358066,23.57639028,321,266,282,1525,1,55,283,2.555464719,2.603432166,Georgia,South
13219,18905,114758,3.7,25.50181335,15.87489676,3.76315128,54.8601386,82,81,212,114,1,1,213,2.25787564,2.302232994,Georgia,South
13223,82294,87459,5.3,34.89388373,29.0561833,8.624231767,27.4257012,475,319,740,671,5,156,745,2.598723484,2.660222026,Georgia,South
13225,11109,58471,6.2,31.31649299,32.03666321,12.33018714,24.31665666,76,87,58,1447,0,-11,58,2.619099162,2.635147982,Georgia,South
13233,17210,54894,5.9,27.24784311,40.40747029,17.8753335,14.46935311,126,119,58,372,0,7,58,2.402594096,2.427392341,Georgia,South
13245,77707,50079,7.6,31.94943329,31.8370465,12.15319862,24.06032159,691,554,-279,10883,2,137,-277,2.599461791,2.628092894,Georgia,South
13247,40347,71984,7.6,32.69768103,28.20338769,9.995737762,29.10319352,235,215,49,883,0,20,49,2.680408394,2.695989908,Georgia,South
13255,26221,55086,7.5,26.84746919,40.65285062,14.63263827,17.86704192,213,229,175,783,0,-16,175,2.627971886,2.650755934,Georgia,South
13257,9774,51980,6.3,28.07055749,40.86999129,16.18031359,14.87913763,74,85,47,834,0,-11,47,2.029373214,2.52592182,Georgia,South
13261,11659,44677,7.4,27.27568623,35.7437344,15.69925138,21.28132798,86,113,-71,1726,0,-27,-71,2.620815169,2.575414111,Georgia,South
13275,15954,52236,6.2,31.45833333,32.92307692,11.98076923,23.63782051,133,164,3,481,0,-31,3,2.580194364,2.642110877,Georgia,South
13277,19509,52962,5,31.58709107,33.89330976,14.32729148,20.19230769,139,122,-2,918,0,17,-2,2.652850412,2.679154163,Georgia,South
13279,11379,45125,6.5,28.74825662,35.70432357,16.07391911,19.4735007,105,96,35,593,2,9,37,2.50173836,2.55233317,Georgia,South
13281,3619,59273,6.6,34.11391758,26.05583393,6.984354228,32.84589426,17,45,100,898,0,-28,100,2.466866978,2.717127267,Georgia,South
13285,34919,55852,7.2,29.663143,35.76559384,12.09769067,22.47357249,184,238,-47,1563,0,-54,-47,2.796639991,2.808299825,Georgia,South
13295,29083,53407,4.9,29.7200124,35.47473913,14.73292696,20.07232152,188,243,135,1253,0,-55,135,2.472368775,2.584770438,Georgia,South
13297,43150,83037,5.3,29.7773504,32.5674976,12.73319032,24.92196168,245,265,538,766,1,-20,539,2.583549183,2.622862351,Georgia,South
13299,14465,48245,5.5,26.99694996,39.51858874,18.46921111,15.01525019,120,148,-2,2258,0,-28,-2,2.617037576,2.820978985,Georgia,South
13313,40038,61680,7.2,25.04194942,30.99950997,24.61131818,19.34722243,282,228,-145,1090,2,54,-143,2.588030571,2.641423821,Georgia,South
15001,81651,71143,11.4,32.54188432,29.64246082,6.911251252,30.90440361,503,429,-28,2700,13,74,-15,2.629180697,2.659739321,Hawaii,West
15003,405728,96304,10.2,29.94547197,25.2240907,7.107441988,37.72299534,2748,1968,-4530,34887,101,780,-4429,2.668969242,2.689717637,Hawaii,West
15007,30567,81939,16.2,32.86796292,29.61413822,7.282010702,30.23588816,171,149,-126,934,0,22,-126,2.670520171,2.682302175,Hawaii,West
15009,70212,89794,17.7,32.60566104,30.11150541,7.209169344,30.07366421,414,297,-147,2220,5,117,-142,2.640300036,2.653992429,Hawaii,West
16001,248859,87748,5.5,31.58498916,19.57941263,4.934716207,43.900882,1231,873,3144,13481,16,358,3160,2.557238097,2.651220452,Idaho,West
16005,40215,62120,5,37.86138893,25.68308903,6.24966926,30.20585278,282,192,148,2260,1,90,149,2.557465029,2.619361446,Idaho,West
16011,21718,70052,4,36.43495894,31.97367109,10.8041621,20.78720787,152,107,55,503,1,45,56,2.586975268,2.702655539,Idaho,West
16013,11958,98707,7.9,23.972106,21.67921897,8.820083682,45.52859135,38,44,72,383,6,-6,78,2.70838462,2.669261414,Idaho,West
16017,19706,64860,7.8,33.61894754,29.07067604,8.379813004,28.93056341,97,98,331,519,0,-1,331,2.353624403,2.693592758,Idaho,West
16019,56680,74505,4.1,35.42923136,24.41678429,7.940459387,32.21352496,452,229,554,1672,2,223,556,2.562278343,2.64966815,Idaho,West
16027,101384,70594,6,34.89770577,29.98745295,12.2844085,22.83043278,836,396,1572,3227,10,440,1582,2.57118268,2.666014228,Idaho,West
16055,77160,75583,7.1,39.03309071,26.57277071,5.634559271,28.75957931,456,362,1453,1747,0,94,1453,2.554035966,2.637176158,Idaho,West
16057,18716,60108,4.9,30.55860728,21.48229528,3.059241105,44.89985633,109,64,55,2666,4,45,59,2.517294014,2.612425291,Idaho,West
16065,21655,52224,2.8,41.72857301,14.9850316,2.96596075,40.32043464,277,44,-219,14763,-2,233,-221,2.565735092,2.640735025,Idaho,West
16069,20052,65558,5,37.45375042,28.7184662,7.070299361,26.75748402,114,125,57,1112,0,-11,57,2.578290116,2.674302762,Idaho,West
16083,40877,63860,5.3,36.75803688,28.89079244,11.34737479,23.0037959,289,232,264,1710,3,57,267,2.573869841,2.604785287,Idaho,West
17001,29178,61747,6.4,31.61751683,34.87646121,6.548884166,26.9571378,169,183,-103,1624,0,-14,-103,2.458437801,2.530458644,Illinois,Midwest
17007,22454,83695,11.3,31.9879195,30.38189054,14.39498716,23.2352028,135,118,-116,265,0,17,-116,2.681486811,2.737882874,Illinois,Midwest
17019,99877,61205,6.6,26.2373157,22.3426234,4.862972213,46.55708869,524,348,-425,15054,30,176,-395,2.533242266,2.604096817,Illinois,Midwest
17021,12396,56888,8.2,30.26288808,44.10039782,9.088299225,16.54841488,83,98,-65,2908,0,-15,-65,2.567021959,2.627989904,Illinois,Midwest
17029,21345,57712,7.5,33.63255338,30.71845814,8.504669813,27.14431867,117,152,-74,2701,0,-35,-74,2.536753542,2.575849146,Illinois,Midwest
17031,2317178,76614,10.6,24.20755113,22.18223419,11.66152495,41.94868973,14083,15675,-11204,80441,251,-1592,-10953,2.614615051,2.673685729,Illinois,Midwest
17037,48520,71882,8.3,33.81911631,25.86752881,7.643206499,32.67014839,309,232,-226,4827,3,77,-223,2.552828617,2.621712547,Illinois,Midwest
17043,458446,102383,7.6,23.64618467,18.0971287,6.809837331,51.44684929,2385,2098,-1890,13845,93,287,-1797,2.558093652,2.632128,Illinois,Midwest
17049,17915,74800,6.6,35.53025511,31.62977019,6.839553026,26.00042167,120,69,-29,405,0,51,-29,2.593206295,2.862925411,Illinois,Midwest
17055,14251,49108,10.6,39.75059338,32.33997664,10.78627133,17.12315865,100,125,-79,303,0,-25,-79,2.271353165,2.299580387,Illinois,Midwest
17063,22875,93882,8.5,36.00147652,33.96842524,5.806689761,24.22340848,124,127,-27,220,0,-3,-27,2.591813528,2.640285454,Illinois,Midwest
17073,21841,70517,7.9,34.01538197,33.7169259,7.92630431,24.34138782,129,161,-83,738,0,-32,-83,2.556778828,2.605363034,Illinois,Midwest
17077,25040,44756,7.8,34.13092693,22.89020249,7.92667589,35.05219469,146,145,-76,3063,1,1,-75,2.611477713,2.667749451,Illinois,Midwest
17081,15243,58623,10.2,40.29486882,32.71031654,8.621623713,18.37319093,88,124,-80,1683,0,-36,-80,2.838456354,3.012865445,Illinois,Midwest
17083,9784,72363,7.5,35.79298831,37.40901503,6.29048414,20.50751252,49,69,-8,706,0,-20,-8,2.807192221,2.685555499,Illinois,Midwest
17089,237204,93475,9.2,26.79729058,22.728793,12.99482022,37.4790962,1460,1112,-744,5490,5,348,-739,2.562153577,2.63768032,Illinois,Midwest
17091,49107,70494,9,34.77564549,35.80202212,9.039634571,20.38269782,280,338,-190,3869,0,-58,-190,2.560128876,2.628946792,Illinois,Midwest
17093,63726,102509,8,33.64227417,23.52100337,6.392078204,36.44464426,379,174,234,370,1,205,235,2.579361058,2.621958255,Illinois,Midwest
17095,19227,57666,8.7,34.11420629,34.90762727,10.68222621,20.29594023,125,160,-126,3620,0,-35,-126,2.624330904,2.724642508,Illinois,Midwest
17097,334715,101621,8.1,23.97446231,19.65893183,9.412675519,46.95393034,1692,1657,-1156,19960,99,35,-1057,2.565945259,2.632315939,Illinois,Midwest
17099,47696,64711,9.5,36.66770218,35.96225536,8.623278451,18.74676401,248,337,-157,2889,0,-89,-157,2.527977146,2.609718993,Illinois,Midwest
17103,15917,67371,6.9,33.88347187,37.24824169,9.514865729,19.35342072,78,101,-64,2724,0,-23,-64,2.780007651,2.702358862,Illinois,Midwest
17105,14806,74418,6.8,31.44741547,40.36711828,9.714331122,18.47113513,98,103,-33,1808,0,-5,-33,2.913801214,2.925240534,Illinois,Midwest
17107,11242,53775,6.8,31.25446565,40.37460447,8.502602838,19.86832704,52,85,-49,3218,0,-33,-49,2.317471784,2.389136816,Illinois,Midwest
17109,11861,52812,7.2,29.72908319,32.73727648,5.729322409,31.80431792,67,95,-95,2483,0,-28,-95,2.54432174,2.612154029,Illinois,Midwest
17111,149337,99128,8,31.65041117,26.87777824,6.280639398,35.19117119,771,708,-398,1851,1,63,-397,2.563903302,2.638908984,Illinois,Midwest
17113,79040,71825,6.9,26.14767437,22.78128903,4.19710101,46.87393559,416,310,-155,8603,12,106,-143,2.547947109,2.60319677,Illinois,Midwest
17115,42400,60648,10,31.38264029,37.54011905,6.950669476,24.12657118,305,315,-217,3009,0,-10,-217,2.59727434,2.662083707,Illinois,Midwest
17119,120728,67441,7.8,34.59414045,28.32154376,6.300241212,30.78407459,664,795,-159,6710,1,-131,-158,2.578485276,2.653079531,Illinois,Midwest
17121,15463,58489,9.3,36.93986534,36.11175606,9.658695147,17.28968346,111,130,-65,846,0,-19,-65,2.635928085,2.717005493,Illinois,Midwest
17127,4873,52880,10.1,38.72437358,34.25770031,10.74576607,16.27216005,32,49,-20,255,0,-17,-20,2.555354125,2.641063926,Illinois,Midwest
17133,17360,100487,5.6,33.31458869,24.22879177,4.225578406,38.23104113,85,89,0,281,0,-4,0,2.659111916,2.726555877,Illinois,Midwest
17137,14767,64842,6.9,26.91840278,39.44878472,10.37326389,23.25954861,78,103,-53,2467,0,-25,-53,2.525024219,2.576880209,Illinois,Midwest
17141,22134,78577,8.2,34.13378596,32.86493405,8.959875341,24.04140464,117,129,-75,495,0,-12,-75,2.510164968,2.569146042,Illinois,Midwest
17143,74797,65421,10.4,31.21108009,27.67463372,6.647561157,34.46672503,543,514,-526,4721,1,29,-525,2.559377479,2.640135249,Illinois,Midwest
17161,62003,62652,9.5,35.45296256,30.70899816,9.774053295,24.06398599,386,438,-256,4390,1,-52,-255,2.583888909,2.635890073,Illinois,Midwest
17163,112752,67185,9.2,34.9899561,27.01149754,7.255069163,30.74347719,708,872,-419,4609,-4,-164,-423,2.599109964,2.667504746,Illinois,Midwest
17167,88597,73684,8.3,30.38248649,28.20572816,6.291906437,35.11987891,531,550,-198,3687,1,-19,-197,2.553071956,2.624927594,Illinois,Midwest
17177,19520,60988,7.4,37.77742398,31.96624741,8.524120363,21.73220825,106,137,-93,718,0,-31,-93,2.537972417,2.682066195,Illinois,Midwest
17179,56830,73285,8.2,35.32054699,30.32604084,5.999717148,28.35369502,294,372,-184,2471,0,-78,-184,2.510345124,2.593238177,Illinois,Midwest
17183,28937,52083,9.3,33.02295969,41.47865186,9.265449047,16.2329394,214,237,-165,2683,0,-23,-165,2.62940935,2.698622039,Illinois,Midwest
17195,25404,62038,8.1,33.10407007,37.83616692,8.98763524,20.07212777,161,183,-104,961,0,-22,-104,2.585701363,2.70054352,Illinois,Midwest
17197,321502,97076,9.1,29.36964375,25.67515255,8.496645358,36.45855835,1700,1600,-645,9521,4,100,-641,2.607355888,2.666085121,Illinois,Midwest
17199,28627,64152,8.8,36.89492203,28.08394579,7.563865004,27.45726718,158,194,-19,2038,0,-36,-19,2.527524805,2.633638731,Illinois,Midwest
17201,120013,62557,11.5,33.25150578,30.79926873,11.35331376,24.59591173,826,891,-383,3594,3,-65,-380,2.580137845,2.660796448,Illinois,Midwest
18001,15847,60620,5.7,26.07787627,45.65832831,13.03197661,15.23181881,168,87,-45,482,0,81,-45,2.464982972,2.487576891,Indiana,Midwest
18003,171154,65967,7.9,31.1984851,27.99581988,9.670854646,31.13484038,1273,952,256,6286,8,321,264,2.602110246,2.655941874,Indiana,Midwest
18005,40833,68910,6.7,25.3867428,31.37835668,7.854402712,35.38049781,256,228,-58,1247,19,28,-39,2.570666006,2.623026098,Indiana,Midwest
18011,34582,102805,4.4,25.13018957,19.37714839,5.00586625,50.48679579,191,184,323,830,0,7,323,2.561828418,2.553112314,Indiana,Midwest
18017,16436,60452,7,26.89456501,43.24563088,14.21932015,15.64048396,95,114,-56,715,2,-19,-54,2.58877414,2.60347556,Indiana,Midwest
18019,57233,68493,7.3,32.19280981,33.09536842,9.250352289,25.46146948,342,356,273,1670,0,-14,273,2.551206185,2.625060846,Indiana,Midwest
18027,15925,63777,3.9,28.28379674,33.78235858,22.82358581,15.11025887,100,92,-37,647,0,8,-37,2.603523346,2.717175997,Indiana,Midwest
18029,23612,77621,7.1,27.23523636,37.97727592,8.75017534,26.03731239,135,134,59,536,0,1,59,2.544867217,2.603393703,Indiana,Midwest
18033,20691,72910,7,29.90828172,42.24455952,7.706366129,20.14079264,128,112,7,418,0,16,7,2.515097694,2.546870301,Indiana,Midwest
18035,48643,54059,7.5,31.10177338,34.15426252,9.053486219,25.69047789,272,404,-55,7863,4,-132,-51,2.600041952,2.663352052,Indiana,Midwest
18037,21585,71171,4.6,27.50126199,37.42217735,10.7656066,24.31095406,130,100,-25,711,1,30,-24,2.363380408,2.627907687,Indiana,Midwest
18039,102206,63777,7.7,25.55753484,36.91159718,17.79906574,19.73180223,707,461,-326,2425,8,246,-318,2.567084833,2.6112933,Indiana,Midwest
18043,38654,74264,6.6,30.70563974,30.53169551,7.454496548,31.30816821,181,236,67,1722,1,-55,68,2.577341362,2.627823406,Indiana,Midwest
18047,10657,74779,6,28.44128292,40.79620616,11.27542743,19.48708349,54,56,-6,155,0,-2,-6,2.707398325,2.873664576,Indiana,Midwest
18053,29612,51053,6.5,31.09543873,37.28704891,11.23603224,20.38148012,189,256,-107,4720,0,-67,-107,2.548120277,2.63161951,Indiana,Midwest
18057,176424,117068,4.8,21.25559363,14.2009609,2.709029676,61.83441579,912,631,1185,2610,33,281,1218,2.547706728,2.600635429,Indiana,Midwest
18059,38490,87845,5.7,29.94598779,29.34956632,6.507855522,34.19659037,181,195,361,834,1,-14,362,2.515653671,2.557968942,Indiana,Midwest
18063,85742,94760,5.1,27.44167982,26.46161983,6.512523448,39.58417691,436,418,800,3732,7,18,807,2.573103085,2.640093385,Indiana,Midwest
18065,20452,54714,6.7,30.99505474,42.94085699,9.367407026,16.69668125,126,176,26,3732,0,-50,26,2.46154201,2.540970683,Indiana,Midwest
18067,33099,56960,11.1,33.90296161,38.18467706,7.932750458,19.97961088,225,342,12,1163,3,-117,15,2.589044827,2.661122899,Indiana,Midwest
18069,16874,59491,6.7,27.04737132,42.87459604,6.963821234,23.1142114,102,99,-34,1243,1,3,-33,2.496737924,2.532704818,Indiana,Midwest
18071,21452,66082,7.3,29.36561743,39.52865214,10.83131558,20.27441485,165,103,-28,753,1,62,-27,2.508289115,2.514195708,Indiana,Midwest
18077,13849,64214,7.6,31.70133058,38.82788615,11.3680403,18.10274297,79,89,-37,2360,1,-10,-36,2.497500383,2.589037646,Indiana,Midwest
18081,78361,83036,5.7,28.59744166,30.83327294,7.254674591,33.31461081,444,457,465,2973,3,-13,468,2.547055023,2.605091001,Indiana,Midwest
18083,17192,58238,6.1,36.30888541,35.99950499,9.904298325,17.78731128,93,116,-17,1669,0,-23,-17,2.540859709,2.660920103,Indiana,Midwest
18085,38835,71611,6.3,27.47384763,35.93501645,11.96724947,24.62388645,240,173,-161,1526,2,67,-159,2.556363929,2.608884433,Indiana,Midwest
18089,202901,66169,10.5,30.67503915,34.65206858,9.776864013,24.89602825,1380,1553,229,4314,14,-173,243,2.594412542,2.654888323,Indiana,Midwest
18091,42814,66336,9.8,29.49660276,39.2892324,9.505948322,21.70821651,288,361,-84,6392,0,-73,-84,2.572076679,2.619749185,Indiana,Midwest
18093,19243,60141,7.1,31.4545341,38.42742943,9.64901324,20.46902323,103,159,49,598,0,-56,49,2.665156983,2.828649581,Indiana,Midwest
18095,53809,58926,8.1,30.99974982,39.43088989,9.518888756,20.05047154,354,452,106,5783,1,-98,107,2.583282378,2.655450936,Indiana,Midwest
18097,453683,62776,8.1,26.56556027,27.07098756,12.30223861,34.06121356,3341,2972,-1360,16564,156,369,-1204,2.567904148,2.633463503,Indiana,Midwest
18099,21234,70938,6.6,27.56263502,38.10660046,13.88127559,20.44948892,123,120,-23,672,0,3,-23,2.609191433,2.650124359,Indiana,Midwest
18105,64164,64299,5.7,24.28041972,21.42616481,5.173036196,49.12037928,285,301,-154,12217,18,-16,-136,2.535475835,2.607647931,Indiana,Midwest
18107,17650,66283,5.3,28.32178599,41.08160123,11.05850654,19.53810624,99,120,16,1061,0,-21,16,2.582498573,2.568399634,Indiana,Midwest
18109,33564,75542,5.6,30.42076319,39.45718186,9.560641728,20.56141323,181,213,69,665,1,-32,70,2.619572315,2.666404556,Indiana,Midwest
18113,20947,69567,8.5,25.41534996,39.4386909,17.3680423,17.77791684,182,141,-51,685,0,41,-51,2.561255392,2.623909676,Indiana,Midwest
18127,77512,84352,8.2,29.57773196,34.15092784,6.190515464,30.08082474,397,477,126,3316,0,-80,126,2.566746383,2.653690264,Indiana,Midwest
18133,15170,68301,6.4,32.37358997,38.56590676,9.178038968,19.88246431,80,110,-25,4142,0,-30,-25,2.448522176,2.625361317,Indiana,Midwest
18137,13036,63571,6.5,29.05177194,42.21404446,9.376417805,19.35776579,93,87,-15,531,0,6,-15,2.57142869,2.673324854,Indiana,Midwest
18141,122232,61028,8.6,28.87270154,29.69773215,8.80519393,32.62437238,784,750,-324,12607,7,34,-317,2.565467831,2.619579201,Indiana,Midwest
18145,21363,66045,7.4,29.62681847,41.31878558,9.636306135,19.41808982,126,145,17,734,0,-19,17,2.49799021,2.5592717,Indiana,Midwest
18157,85829,56088,6.6,24.70372528,27.18278789,8.049313865,40.06417296,497,319,-139,15899,39,178,-100,2.527366289,2.605932941,Indiana,Midwest
18163,85615,57997,7.3,31.74001749,32.5496292,8.628031996,27.08232132,521,569,212,6728,7,-48,219,2.56564872,2.628159855,Indiana,Midwest
18167,42592,52286,8,30.97823704,33.56231456,9.587979947,25.87146845,307,297,-68,8879,1,10,-67,2.56171916,2.615802479,Indiana,Midwest
18169,13592,64025,6.2,28.23464152,41.97753432,8.186566819,21.60125734,75,99,-25,1197,0,-24,-25,2.52385642,2.567997414,Indiana,Midwest
18173,30104,84567,5.5,31.12421542,28.86819004,4.505349684,35.50224486,158,193,127,936,0,-35,127,2.51036158,2.599782922,Indiana,Midwest
18175,12621,65342,7.1,31.37185034,42.88114024,11.92669891,13.82031051,82,66,50,337,0,16,50,2.72963319,2.711400861,Indiana,Midwest
18177,28099,51622,6.9,31.44931694,36.67983492,11.65500651,20.21584163,206,247,-10,2151,0,-41,-10,2.6167778,2.654710724,Indiana,Midwest
19013,63188,62020,6.1,32.32607675,30.78931851,6.747536012,30.13706873,436,365,-199,4484,7,71,-192,2.54441073,2.592447106,Iowa,Midwest
19017,13146,83797,3.8,30.13392857,30.5019305,4.138513514,35.22562741,63,69,20,1567,0,-6,20,2.558877143,2.645595694,Iowa,Midwest
19021,11222,67552,3.6,26.72123623,31.75489596,19.45379437,22.07007344,58,54,-26,811,6,4,-20,3.424175624,2.453773872,Iowa,Midwest
19031,9937,71563,4.3,33.29302396,40.99463381,4.232484317,21.47985791,45,47,-6,263,0,-2,-6,3.015049404,2.619020112,Iowa,Midwest
19033,21888,63279,5.1,34.34082972,35.86839443,5.525997976,24.26477788,111,146,-71,1020,0,-35,-71,2.522753891,2.573147599,Iowa,Midwest
19045,20548,61136,6.6,34.35938809,36.20566606,7.335464052,22.0994818,136,135,-39,641,0,1,-39,2.608824384,2.665827885,Iowa,Midwest
19049,48911,109138,3.5,26.43240562,18.02176323,3.919423537,51.62640761,304,172,721,711,2,132,723,2.476370012,2.588683042,Iowa,Midwest
19057,17216,59688,7.3,33.87126693,36.25672417,6.035985902,23.836023,109,124,-74,525,1,-15,-73,2.515776883,2.528718403,Iowa,Midwest
19059,9283,75406,5,37.68387872,27.31912339,2.686880817,32.31011708,39,52,80,310,1,-13,81,2.617679121,2.779218347,Iowa,Midwest
19061,51877,73492,5.7,28.68496567,32.52505221,5.925391746,32.86459038,279,231,-38,4172,1,48,-37,2.510917832,2.576335861,Iowa,Midwest
19071,3581,69018,3,38.61849097,35.19659936,5.037194474,21.1477152,17,16,-31,92,0,1,-31,2.92246161,2.806166845,Iowa,Midwest
19099,18167,69047,5.2,33.54984044,39.90613854,6.630373569,19.91364746,114,115,-5,1935,0,-1,-5,2.618490141,2.687822111,Iowa,Midwest
19101,9257,59603,5.4,30.14537108,23.60792315,4.616169345,41.63053643,45,46,23,776,5,-1,28,2.472758287,2.576298155,Iowa,Midwest
19103,80507,74909,4.7,25.87139065,15.80475649,3.755349694,54.56850317,402,190,-107,9419,42,212,-65,2.541687771,2.616716414,Iowa,Midwest
19105,9647,70671,5.6,34.31594357,39.33324461,5.602874634,20.74793718,49,47,4,1441,0,2,4,2.069449677,2.367133684,Iowa,Midwest
19113,111888,74134,6.2,34.37709513,26.06999419,4.719914694,34.83299598,666,513,-112,5333,17,153,-95,2.538535675,2.617737928,Iowa,Midwest
19125,17189,73451,4.1,28.8239506,32.69041439,5.419314419,33.06632059,86,77,-21,1411,0,9,-21,2.493658194,2.588072087,Iowa,Midwest
19127,16294,69818,6.9,31.03578296,34.54620866,12.97085329,21.44715508,122,127,-24,1060,14,-5,-10,2.495286932,2.611957927,Iowa,Midwest
19139,20042,69096,5.8,32.61268752,35.15573572,9.517375186,22.71420157,104,126,-76,721,2,-22,-74,2.527200602,2.547714409,Iowa,Midwest
19153,248404,77369,5.9,28.67607588,24.27063542,7.507765614,39.54552309,1532,1116,-80,8908,66,416,-14,2.537839851,2.618388575,Iowa,Midwest
19155,44576,68712,5.2,33.58358672,33.9189994,8.957399455,23.54001442,273,258,-34,2185,2,15,-32,2.513502597,2.582804058,Iowa,Midwest
19157,9280,69566,4.8,27.43166708,39.04621193,5.359927768,28.16219322,35,60,-8,1592,1,-25,-7,2.635172727,2.541151966,Iowa,Midwest
19163,80925,68576,6.7,32.18119112,25.74781292,5.843707941,36.22728802,510,417,-186,3226,4,93,-182,2.557867006,2.632988722,Iowa,Midwest
19167,20584,75994,2.6,32.6413945,27.59008481,9.381003702,30.38751699,110,55,-38,2367,0,55,-38,2.608991184,2.725930537,Iowa,Midwest
19169,54611,68720,3.5,27.92628132,15.83085827,2.905338512,53.33752189,200,120,-15,11870,16,80,1,2.530458745,2.612042819,Iowa,Midwest
19179,16299,61555,5.9,30.19488632,38.06945948,12.30948613,19.42616807,114,152,-71,957,0,-38,-71,2.413158536,2.669004795,Iowa,Midwest
19181,26458,90943,4.5,35.03968031,28.99195137,3.284178533,32.68418979,129,106,167,1667,0,23,167,2.511867778,2.545594673,Iowa,Midwest
19187,17662,67110,5.2,39.22689752,32.58304812,7.678679283,20.51137508,123,118,-19,3117,1,5,-18,2.491912953,2.532721287,Iowa,Midwest
19193,51635,66830,5.2,31.149095,32.55621056,12.89658441,23.39811002,383,291,-132,2898,4,92,-128,2.556005837,2.637401769,Iowa,Midwest
20009,13084,56711,4.6,40.3808082,28.19960405,9.747292419,21.67229533,71,80,-61,537,1,-9,-60,2.515894364,2.521023706,Kansas,Midwest
20015,30435,80214,6.5,33.3281493,28.15374361,5.947567207,32.57053988,148,173,25,2615,0,-25,25,2.414401781,2.475035422,Kansas,Midwest
20035,15774,56416,6.5,36.35204082,30.97730471,8.413969036,24.25668543,93,102,-17,1947,0,-9,-17,2.509772788,2.590227576,Kansas,Midwest
20037,17991,51835,5.5,33.46426437,28.78490308,5.776620272,31.97421228,114,126,-19,1475,1,-12,-18,2.602507847,2.652042242,Kansas,Midwest
20045,60493,67482,5.9,24.40492167,19.45076212,4.113633474,52.03068273,241,210,-71,8505,11,31,-60,2.531423371,2.617832658,Kansas,Midwest
20051,16543,61675,3.4,28.15337459,27.58082239,4.71921809,39.54658493,79,61,-14,1832,2,18,-12,2.599597457,2.597560512,Kansas,Midwest
20055,19974,69966,3.3,28.49653457,22.91629643,28.85196375,19.73520526,128,76,-201,559,2,52,-199,2.621682036,2.65659805,Kansas,Midwest
20057,16773,67714,3.3,28.27459363,27.96639658,23.04518566,20.71382413,147,65,-149,668,3,82,-146,2.557802203,2.614785317,Kansas,Midwest
20059,13531,67263,5.3,31.79164541,35.14141586,7.770787281,25.29615145,62,65,11,525,0,-3,11,2.39916697,2.395707303,Kansas,Midwest
20079,15965,73854,5.3,35.10671067,25.23212321,8.171617162,31.48954895,90,84,-41,1127,2,6,-39,2.507970921,2.554268378,Kansas,Midwest
20091,326064,99174,5,25.4641562,14.13152066,3.529184559,56.87513859,1740,1043,306,5714,36,697,342,2.511399619,2.598722994,Kansas,Midwest
20103,34703,79117,5.8,29.91062668,26.87443138,6.600424568,36.61451737,213,184,12,6112,-6,29,6,2.576436209,2.621437832,Kansas,Midwest
20111,15925,55863,4.6,28.07423401,33.38474193,10.82665022,27.71437384,84,89,-65,1235,4,-5,-61,2.551729792,2.612116909,Kansas,Midwest
20113,16662,73766,3.4,35.0970898,24.14516049,7.672340638,33.08540908,72,98,-14,1921,0,-26,-14,2.532424978,2.580653724,Kansas,Midwest
20121,16787,82606,4.9,31.08045199,31.53751746,5.235092471,32.14693808,83,73,15,472,0,10,15,2.600235972,2.550363619,Kansas,Midwest
20125,13855,54955,7.3,36.99355762,31.57241708,10.12646147,21.30756383,85,105,-67,763,0,-20,-67,2.645345205,2.604637233,Kansas,Midwest
20155,28277,57663,5.4,39.73022685,30.90600387,8.81479036,20.54897892,170,182,-6,2816,0,-12,-6,2.535176355,2.525296956,Kansas,Midwest
20161,32091,55876,4.8,31.0188387,17.12080555,3.883924867,47.97643088,174,103,-68,11218,13,71,-55,2.505388095,2.576878539,Kansas,Midwest
20169,28040,57563,5.4,34.38754609,29.425099,7.100914926,29.08643998,151,133,-69,1561,0,18,-69,2.528314326,2.589043482,Kansas,Midwest
20173,236433,64720,8.7,31.98397903,25.9362074,10.49431984,31.58549374,1713,1244,298,11103,39,469,337,2.573462438,2.631284954,Kansas,Midwest
20175,9434,63579,4.2,31.35874723,27.92628915,28.05283138,12.66213224,90,30,-152,342,1,60,-151,2.60914313,2.690022089,Kansas,Midwest
20177,86272,61255,5.8,30.85778707,30.26201017,6.546139794,32.33406297,473,493,-198,4603,1,-20,-197,2.54030687,2.612561457,Kansas,Midwest
20191,10015,62921,8.2,33.68067005,33.62791004,5.975070896,26.71634901,60,65,-41,300,0,-5,-41,2.635097204,2.732470626,Kansas,Midwest
20209,71985,58701,7.9,29.12305516,32.31023102,18.09618105,20.47053277,587,449,-483,3018,21,138,-462,2.573011265,2.613977892,Kansas,Midwest
21009,16643,50658,7.4,25.83916537,42.88491446,13.46552618,17.81039399,108,128,33,634,0,-20,33,2.641185617,2.64794632,Kentucky,South
21015,66475,90265,5.3,29.96995411,28.23983887,6.414193108,35.37601391,414,264,291,1329,6,150,297,2.540468832,2.617449731,Kentucky,South
21017,8966,56879,5.7,27.57652143,33.53258912,13.43176089,25.45912856,43,57,50,97,0,-14,50,2.750677465,2.474242449,Kentucky,South
21019,15948,55397,8.2,35.69305199,33.97936582,10.95243647,19.37514572,108,178,9,2269,0,-70,9,2.57557828,2.635263916,Kentucky,South
21021,11597,57975,7.1,28.32665669,35.7401419,8.562189295,27.37101211,72,76,145,2937,0,-4,145,2.506971013,2.528712234,Kentucky,South
21029,39294,77192,6.2,31.16440667,39.5027997,10.42636443,18.9064292,211,192,90,136,0,19,90,2.575070934,2.621192949,Kentucky,South
21035,16599,51949,6.1,27.63473054,31.42429427,8.618477331,32.32249786,78,107,75,3718,0,-29,75,2.592684862,2.613049193,Kentucky,South
21037,46611,74149,5.4,26.76183344,26.89174525,6.891439576,39.45498174,247,227,7,2520,0,20,7,2.582149751,2.656031633,Kentucky,South
21047,22426,56610,7.8,34.50117908,32.40531306,13.11901439,19.97449348,355,180,-237,4855,3,175,-234,2.605117374,2.606013118,Kentucky,South
21049,15784,61641,6.4,30.65378843,37.04929388,10.05887559,22.2380421,99,113,50,440,1,-14,51,2.611441473,2.645391115,Kentucky,South
21059,42883,65949,5.9,31.44014765,34.22008824,9.09824956,25.24151455,274,276,47,2486,0,-2,47,2.527269736,2.598247496,Kentucky,South
21067,161205,63667,5.6,26.06350994,19.00955417,7.616611467,47.31032442,883,714,-234,13516,24,169,-210,2.531982632,2.594253004,Kentucky,South
21073,23017,58456,6.4,30.14647064,30.49954487,7.522136099,31.8318484,143,161,61,1674,0,-18,61,2.534476779,2.602681328,Kentucky,South
21089,11932,54462,8.7,34.00760516,37.96307186,9.706378141,18.32294484,80,138,-27,545,0,-58,-27,2.466852955,2.575515434,Kentucky,South
21093,44082,61920,7,37.19823646,30.79869885,7.578364428,24.42470025,353,261,-5,2546,2,92,-3,2.564704517,2.609849158,Kentucky,South
21095,5727,36022,11.5,32.03735052,34.51100311,20.75028668,12.70135969,85,108,-56,561,0,-23,-56,2.645486122,2.638448979,Kentucky,South
21101,19301,55530,6,31.65969765,38.42071406,10.88774526,19.03184304,119,139,-98,994,0,-20,-98,2.615275691,2.682164782,Kentucky,South
21107,16619,52198,7.2,31.93630573,39.16242038,12.27388535,16.62738854,103,187,19,979,0,-84,19,2.551062687,2.663427224,Kentucky,South
21111,361264,64719,6.7,28.99697796,25.94081985,8.484342844,36.57785935,2340,2263,-523,15937,72,77,-451,2.578780233,2.616024352,Kentucky,South
21113,24363,69216,5.5,28.78678911,29.30958177,9.493250719,32.4103784,153,125,-4,1499,0,28,-4,2.551452436,2.588331639,Kentucky,South
21117,80682,77284,5.6,27.14076751,27.72156255,7.537429014,37.60024092,561,403,24,1816,4,158,28,2.556277477,2.631686663,Kentucky,South
21125,23096,50721,6.8,27.08275862,39.48275862,16.91264368,16.52183908,181,193,124,1083,0,-12,124,2.635231291,2.746756463,Kentucky,South
21145,26594,60026,6.9,32.59033613,32.31092437,7.159663866,27.93907563,167,183,42,2158,0,-16,42,2.580964874,2.629303708,Kentucky,South
21151,42876,60994,5.9,28.34017019,28.73343052,8.746652202,34.17974709,248,239,277,5824,0,9,277,2.573005438,2.642155413,Kentucky,South
21161,6283,49029,7.8,31.45276218,32.64313857,14.83779026,21.06630899,48,43,2,251,0,5,2,2.538556231,2.602601601,Kentucky,South
21167,9109,65292,7.1,34.00664952,34.62768961,8.914120821,22.45154005,53,57,9,258,0,-4,9,2.380064572,2.453119385,Kentucky,South
21177,9022,48190,8.5,28.86659065,42.77765108,15.38426454,12.97149373,71,88,-27,1724,0,-17,-27,2.562133236,2.614969045,Kentucky,South
21179,21026,66681,6.8,32.31562375,36.74868027,8.10360263,22.83209335,110,109,38,640,0,1,38,2.56899971,2.663860629,Kentucky,South
21185,30718,116173,4.7,28.24695888,20.26687632,5.859485903,45.6266789,125,112,60,3943,0,13,60,2.521522319,2.546029845,Kentucky,South
21193,7384,43945,8.7,30.23363049,35.03432729,20.49390306,14.23813915,70,127,-47,656,0,-57,-47,2.517119378,2.535572687,Kentucky,South
21195,17439,41837,8.2,25.83361729,38.97921433,19.17684856,16.01031982,124,221,-123,1820,0,-97,-123,2.483255066,2.472013124,Kentucky,South
21199,23738,46380,7.2,31.48000431,35.51363587,15.09324135,17.91311847,171,210,107,1141,0,-39,107,2.585323476,2.628455918,Kentucky,South
21209,27887,86169,6.1,32.30617078,28.7484059,5.699711111,33.2457122,171,104,323,1109,0,67,323,2.58640052,2.58809806,Kentucky,South
21211,23916,81815,5.3,28.20117888,28.92686828,11.8272563,31.04469654,133,112,116,1178,1,21,117,2.628477582,2.63575916,Kentucky,South
21217,12141,52414,5.9,29.88452388,36.83049962,11.30969651,21.97527999,74,100,0,1409,0,-26,0,2.463683689,2.427337146,Kentucky,South
21227,59022,60651,6.4,29.10936593,26.45606055,11.07518093,33.35939258,406,308,338,5901,8,98,346,2.517372765,2.569123866,Kentucky,South
21235,12758,43604,7,23.73475214,39.55792024,16.89592525,19.81140237,123,131,-17,1885,0,-8,-17,2.519437119,2.578884254,Kentucky,South
21239,14039,76633,4.9,24.12855772,25.54631702,8.613154248,41.71197101,59,62,26,543,0,-3,26,2.582661261,2.594100071,Kentucky,South
22001,21408,42981,7.7,23.73639757,43.51981784,19.31742964,13.42635495,176,204,-72,697,0,-28,-72,2.607965491,2.630649076,Louisiana,South
22003,7545,51423,9.6,25.1621352,42.47318533,20.74083313,11.62384635,52,81,-41,2819,0,-29,-41,2.652586284,2.671539409,Louisiana,South
22005,59474,81284,7,29.71670613,30.47699501,11.33294466,28.47335419,404,266,309,618,5,138,314,2.611974863,2.61095891,Louisiana,South
22007,7803,54403,10.6,20.6140053,43.95164029,21.78224547,13.65210895,68,85,-62,161,0,-17,-62,2.557569285,2.494201989,Louisiana,South
22009,13602,41587,8.4,29.13705584,36.98063546,22.95920286,10.92310585,129,141,-39,2807,0,-12,-39,2.576818814,2.607128897,Louisiana,South
22015,52730,63812,6.6,34.85446901,28.51781929,9.308655416,27.31905628,386,292,-135,2180,6,94,-129,2.556148577,2.583057312,Louisiana,South
22017,91444,47699,9.4,30.55311401,31.66059769,12.4974887,25.2887996,696,933,-662,4055,0,-237,-662,2.599522324,2.621403346,Louisiana,South
22019,87676,61797,9.5,30.2898801,34.39915368,10.60566806,24.70529816,659,603,-388,2597,6,56,-382,2.643694412,2.676923884,Louisiana,South
22033,206505,61376,8.2,26.78932642,25.80506474,9.175165453,38.23044339,1300,1361,-920,17326,49,-61,-871,2.605917733,2.632058196,Louisiana,South
22039,10910,40933,8.2,23.88712053,42.66235926,20.87985177,12.57066844,108,107,-51,1437,0,1,-51,2.729623458,2.789631816,Louisiana,South
22045,24626,45077,10,26.33686017,42.19220871,16.81661204,14.65431909,181,254,-162,660,1,-73,-161,2.652544959,2.636102247,Louisiana,South
22047,12164,53205,10.4,27.53869385,36.84409211,18.97414119,16.64307286,62,125,-111,2791,0,-63,-111,2.593116321,2.609586783,Louisiana,South
22051,188494,61157,9.6,28.93810294,27.66643502,13.4495104,29.94595164,1284,1555,-894,2939,78,-271,-816,2.625685913,2.659810968,Louisiana,South
22053,11656,52414,8,24.64052288,43.10457516,17.25957049,14.99533147,96,90,-50,662,0,6,-50,2.710228171,2.75095238,Louisiana,South
22055,105162,58641,7.4,26.13992028,28.91938995,10.0836434,34.85704637,707,530,130,2782,11,177,141,2.625466719,2.65418113,Louisiana,South
22057,38149,59575,6.9,23.82585992,38.58040621,17.14988312,20.44385075,253,338,-53,2432,0,-85,-53,2.613766686,2.62978601,Louisiana,South
22061,19507,44752,6.6,23.86505623,29.57479838,10.60921586,35.95092954,136,124,-109,5312,2,12,-107,2.595247791,2.60678784,Louisiana,South
22063,63814,72887,6.7,29.96077048,37.31786292,12.44136328,20.28000332,419,341,460,1046,2,78,462,2.587164067,2.628899427,Louisiana,South
22065,3199,33403,9,28.15947053,35.15600378,23.88906398,12.79546171,27,37,-72,825,0,-10,-72,2.717957835,3.026290615,Louisiana,South
22067,8936,39493,10.3,31.27218935,39.10650888,16.92899408,12.69230769,75,117,-120,1160,0,-42,-120,2.617994251,2.666090066,Louisiana,South
22069,14844,42178,7.2,25.64971751,36.06779661,12.66892655,25.61355932,106,107,-123,2117,0,-1,-123,2.608423056,2.62037434,Louisiana,South
22071,156655,51913,12.4,25.93055535,21.26434637,10.85361849,41.95147978,1056,1311,-615,15533,11,-255,-604,2.630812963,2.660166174,Louisiana,South
22073,63661,47283,7.8,29.18288684,31.22614916,12.0467141,27.54424991,493,482,-281,5300,0,11,-281,2.629833135,2.646259244,Louisiana,South
22075,8782,71876,7.4,32.9229573,32.87112033,14.35884144,19.84708093,54,63,-46,790,0,-9,-46,2.65616434,2.699693033,Louisiana,South
22077,8619,56457,8.3,30.84487535,35.18698061,18.46260388,15.50554017,56,99,-40,153,1,-43,-39,2.453117917,2.724776657,Louisiana,South
22079,50813,55870,6.6,27.93731549,37.06110923,12.58241053,22.41916475,406,460,-302,3337,1,-54,-301,2.628249514,2.649910862,Louisiana,South
22081,3331,44139,6.6,19.07686212,50.99049128,18.75990491,11.17274168,19,45,-11,168,0,-26,-11,2.622285096,2.631190354,Louisiana,South
22085,8618,45072,5.9,25.69219586,45.51642107,14.31969867,14.4716844,57,90,-21,345,0,-33,-21,2.83001918,2.7440871,Louisiana,South
22087,17818,51485,10.4,35.91583139,28.16147192,18.73197858,17.19071811,133,124,73,224,0,9,73,2.627838353,2.659885411,Louisiana,South
22089,22268,75223,8.1,31.66049559,30.19082882,10.93420678,27.21446881,145,151,-36,585,0,-6,-36,2.652485008,2.64431578,Louisiana,South
22093,7892,67938,10.3,27.65681327,40.77144917,11.37707282,20.19466474,60,70,-63,141,0,-10,-63,2.601959107,2.623079518,Louisiana,South
22095,16863,60569,11.6,28.11489995,39.90630788,13.26215637,18.7166358,115,153,-77,366,0,-38,-77,2.569251209,2.602315638,Louisiana,South
22097,29087,42765,9.1,26.33540605,39.9160923,19.4186395,14.32986215,264,334,-178,1216,0,-70,-178,2.61660986,2.616011395,Louisiana,South
22099,19808,54265,8.6,22.85982532,44.6755242,17.12139748,15.34325301,179,175,-136,272,0,4,-136,2.590213479,2.641113596,Louisiana,South
22101,17425,48242,9.6,21.44352416,46.02105519,19.41385274,13.12156791,152,177,-213,668,2,-25,-211,2.642625313,2.692825161,Louisiana,South
22103,107919,78629,7,30.83665899,24.00203325,8.595870781,36.56543699,650,757,461,2495,12,-107,473,2.60014301,2.658136588,Louisiana,South
22105,50250,54942,10,26.68353115,34.95804583,16.13005229,22.22837073,455,376,414,4503,1,79,415,2.63701464,2.647438368,Louisiana,South
22109,41743,57376,8.1,25.61592886,39.91163064,16.73424872,17.73819178,376,333,-223,1023,2,43,-221,2.617578717,2.636076543,Louisiana,South
22113,21633,50554,7.8,24.78727048,42.4352591,15.93298032,16.84449011,164,166,-58,570,0,-2,-58,2.646403388,2.607849582,Louisiana,South
22115,14518,52626,7.6,29.03376174,39.44196577,12.43590597,19.08836652,216,108,-223,1709,3,108,-220,2.673948106,2.707448556,Louisiana,South
22117,15105,41779,8.6,25.94659098,45.42991679,15.91304909,12.71044314,140,206,-46,1767,0,-66,-46,2.54209339,2.533684516,Louisiana,South
22119,12721,43698,8.3,29.56125629,43.88236234,13.757692,12.79868936,95,135,-45,391,0,-40,-45,2.657026698,2.627901634,Louisiana,South
22121,12412,71362,7.5,30.1574236,36.1868505,10.59779813,23.05792777,100,84,38,608,0,16,38,2.53437259,2.618472833,Louisiana,South
22127,4310,45646,7.5,21.45296492,46.79706095,15.6473145,16.10265963,28,58,-6,1497,0,-30,-6,2.375256347,2.441606489,Louisiana,South
23001,51281,62848,5.1,32.6631944,36.3615423,7.534903958,23.44035934,296,293,6,4353,1,3,7,2.478848155,2.559183286,Maine,Northeast
23003,27574,51562,5.1,30.03425885,38.77425009,8.817671195,22.37381986,153,204,1,1544,0,-51,1,2.591994525,2.666993593,Maine,Northeast
23005,152096,88571,4.9,24.09780108,20.24023035,3.498426798,52.16354177,733,759,453,9013,45,-26,498,2.532369418,2.625229938,Maine,Northeast
23009,26104,63879,5.4,27.24360473,28.53434972,5.046064631,39.17598092,117,158,66,1366,0,-41,66,2.645007207,2.660907827,Maine,Northeast
23011,58248,63191,4.6,29.97774693,33.96787626,5.161169498,30.89320731,279,372,297,4231,2,-93,299,2.549871834,2.64064329,Maine,Northeast
23013,18488,65615,5,25.12097288,30.07131033,5.704826181,39.10289062,67,109,92,1513,0,-42,92,2.66709086,2.719901854,Maine,Northeast
23019,70142,60761,5,31.62828042,32.42667821,5.468799336,30.47624203,307,404,23,6212,5,-97,28,2.54300167,2.627817895,Maine,Northeast
23031,104512,81315,5,30.73683556,29.78880906,4.903735498,34.57061989,426,546,397,3540,4,-120,401,2.542189029,2.623267852,Maine,Northeast
24001,29022,50582,7.4,27.84778436,40.75356755,10.27497288,21.12367521,148,260,-48,6191,0,-112,-48,2.596960048,2.688157422,Maryland,South
24003,300122,112525,5.5,26.54468027,21.994497,6.220528327,45.2402944,1727,1327,251,9657,-17,400,234,2.584537901,2.645625422,Maryland,South
24005,423067,86198,6.5,26.11908066,24.1574161,8.301364459,41.42213879,2364,2751,-959,22359,64,-387,-895,2.565571919,2.634595259,Maryland,South
24009,47287,118110,5,31.02963661,28.61577427,5.091813254,35.26277586,232,232,100,582,0,0,100,2.566621691,2.631660425,Maryland,South
24013,90511,105096,4.8,27.53518169,27.59776352,5.125945933,39.74110885,450,541,104,3739,0,-91,104,2.579322102,2.658654554,Maryland,South
24015,50515,84513,5.6,28.82402162,35.81706698,8.458045843,26.90086556,277,309,79,1344,1,-32,80,2.569966786,2.650750286,Maryland,South
24017,82636,112932,6.4,32.60123301,30.08529494,5.675528934,31.63794311,433,406,48,1440,0,27,48,2.593635537,2.64754912,Maryland,South
24021,129952,116796,5.6,25.35523121,23.17919528,6.582939502,44.88263401,771,646,920,5190,5,125,925,2.560801117,2.649869268,Maryland,South
24025,133699,100334,5.5,28.79811803,26.34708692,5.372011087,39.48278397,627,631,222,1816,0,-4,222,2.572818844,2.648614131,Maryland,South
24027,179877,133068,4.9,18.36228397,12.41351098,4.748813456,64.47539159,827,560,135,3090,13,267,148,2.586705526,2.655260958,Maryland,South
24031,523592,118020,6,17.503833,13.45831719,8.752052904,60.28579691,2874,2421,-1920,8927,250,453,-1670,2.563680616,2.636429719,Maryland,South
24033,473084,93833,7.8,25.37156784,25.28824403,13.26143417,36.07875395,2796,2701,-2251,19730,174,95,-2077,2.586575638,2.645046763,Maryland,South
24037,55860,112154,4.6,28.61961632,28.64957087,7.630595314,35.1002175,327,270,133,2373,0,57,133,2.594708467,2.693608407,Maryland,South
24041,16953,76583,5.8,27.1062785,23.53560154,8.032269379,41.32585058,95,134,0,472,0,-39,0,2.595395921,2.671204676,Maryland,South
24043,68259,69271,6.5,28.79588867,36.35819411,11.32457772,23.5213395,416,464,-3,8012,0,-48,-3,2.561002524,2.634970679,Maryland,South
24045,46253,68851,7.2,26.8910237,33.37020425,10.60215771,29.13661434,336,310,-79,3672,1,26,-78,2.596666364,2.667597131,Maryland,South
24047,22517,75969,10.9,30.81992299,30.20288281,6.303682496,32.6735117,96,167,132,737,1,-71,133,2.582571707,2.643298233,Maryland,South
24510,258446,54735,8.5,23.84071234,27.93470195,12.79718031,35.42740539,1852,2192,-2182,18017,16,-340,-2166,2.614513079,2.661323269,Maryland,South
25001,98557,89774,10.7,27.54488715,21.43210338,3.617343911,47.40566556,354,895,-352,4405,4,-541,-348,2.562911499,2.662020711,Massachusetts,Northeast
25003,55388,71102,9.9,26.1426647,29.2931508,6.304104926,38.26007957,248,414,-234,5720,0,-166,-234,2.555579377,2.658335379,Massachusetts,Northeast
25005,268029,80702,10.7,25.48906044,30.12685635,13.75209859,30.63198461,1456,1932,-1708,14145,20,-476,-1688,2.579540588,2.637500258,Massachusetts,Northeast
25009,380823,92118,10.3,23.40195074,24.42406719,9.85987796,42.31410411,2026,2710,-1436,19050,94,-684,-1342,2.57381008,2.64824786,Massachusetts,Northeast
25011,36877,69929,7.9,26.45212511,27.16849452,6.07806211,40.30131827,117,267,25,1653,0,-150,25,2.530647367,2.5414811,Massachusetts,Northeast
25013,201794,64030,10.9,27.46953526,30.78267339,12.82270115,28.92509019,1189,1789,-955,14295,64,-600,-891,2.613171023,2.660877479,Massachusetts,Northeast
25015,81884,81878,7.5,23.99991999,20.36462917,4.515361229,51.12008961,262,459,-12307,22716,6,-197,-12301,2.56204113,2.654108863,Massachusetts,Northeast
25017,833448,118494,7.6,16.9653565,17.48388624,6.564039902,58.98671735,4137,4635,-3565,57749,301,-498,-3264,2.556790218,2.645309507,Massachusetts,Northeast
25019,6326,107613,11.8,21.56937799,16.03827751,4.009569378,58.38277512,30,22,-25,66,0,8,-25,2.614134263,2.68944827,Massachusetts,Northeast
25021,356557,115770,8.7,19.34214478,17.37166012,5.640597639,57.64559746,1720,2329,-907,17720,115,-609,-792,2.53755716,2.621805689,Massachusetts,Northeast
25023,255751,102647,9.9,25.56191499,26.46363735,6.764512759,41.2099349,1216,1866,-77,11814,16,-650,-61,2.57564845,2.639533897,Massachusetts,Northeast
25025,410348,84548,10.2,17.20939688,20.50552773,12.39279861,49.89227678,2197,2103,-3813,50897,190,94,-3623,2.569765688,2.642231368,Massachusetts,Northeast
25027,402081,86078,9.2,25.76389131,26.52052011,8.689943211,39.02564537,2116,2665,-1869,28161,98,-549,-1771,2.555688492,2.642211261,Massachusetts,Northeast
26005,57581,75893,7.6,29.66237073,36.32367248,7.947680075,26.06627671,288,288,122,934,2,0,124,2.564745417,2.681427545,Michigan,Midwest
26017,44867,56388,9.5,36.7182094,33.70814925,8.170543461,21.40309789,251,333,-50,1167,0,-82,-50,2.580792415,2.6600812,Michigan,Midwest
26021,66186,61790,9.1,34.15786548,27.91550862,7.677413378,30.24921253,387,482,-63,2505,0,-95,-63,2.656961943,2.678640941,Michigan,Midwest
26023,18113,63634,8.4,32.75745367,38.99435939,11.35213537,16.89605157,154,144,-12,1796,0,10,-12,2.754331805,2.877795512,Michigan,Midwest
26025,55834,59652,10.1,33.58741167,35.12278636,9.085754166,22.20404781,379,442,-60,3062,0,-63,-60,2.606205517,2.652851523,Michigan,Midwest
26033,14479,58924,9.4,34.69451615,36.29038567,7.161855589,21.85324259,75,76,-5,4929,0,-1,-5,2.705863059,2.743532203,Michigan,Midwest
26037,37663,80212,6.8,36.73286171,24.54842532,4.483427299,34.23528567,191,168,2,666,0,23,2,2.827307989,2.849006538,Michigan,Midwest
26041,15363,57019,9.1,37.30039279,35.11618516,7.565801549,20.0176205,77,119,0,527,0,-42,0,2.394568795,2.500654741,Michigan,Midwest
26045,51916,71499,7.9,36.74567024,27.36045704,5.487789187,30.40608353,283,277,-24,1932,0,6,-24,2.489843218,2.576254557,Michigan,Midwest
26047,15387,69805,10.7,31.13267077,24.63716675,3.987221959,40.24294053,71,95,17,422,0,-24,17,2.5017576,2.597126193,Michigan,Midwest
26049,159533,57443,11.6,36.49829512,31.55486283,9.108612843,22.83822921,1052,1498,-103,4923,0,-446,-103,2.600189845,2.656492554,Michigan,Midwest
26055,44977,74746,8.7,33.17506993,21.68686796,4.874130388,40.26393172,231,245,178,2070,0,-14,178,2.579428242,2.657298513,Michigan,Midwest
26057,16399,58074,8.3,32.67330203,40.1731268,8.134155744,19.01941543,87,136,-35,5776,0,-49,-35,2.641141955,2.682892532,Michigan,Midwest
26059,18298,60070,9.3,29.28555559,40.57828419,9.505824103,20.63033612,131,170,5,1351,0,-39,5,2.947442353,2.871123173,Michigan,Midwest
26061,14744,55623,7.6,28.95087542,28.96925693,5.482284821,36.59758283,79,76,-110,3991,1,3,-109,2.494763398,2.649764312,Michigan,Midwest
26065,135611,60571,7.8,31.03203824,21.21418281,6.500834686,41.25294427,740,659,-385,17517,17,81,-368,2.55029244,2.622003363,Michigan,Midwest
26067,27784,74391,8.2,35.11088212,38.23232649,8.63442176,18.02236964,175,137,14,7161,0,38,14,2.60872348,2.739912803,Michigan,Midwest
26073,30253,54642,8.7,30.7130454,30.43466277,8.048289738,30.80400209,158,130,69,5138,0,28,69,2.648499893,2.692426142,Michigan,Midwest
26075,67782,61299,9.3,34.10666453,35.69248294,7.211825115,22.98902742,402,471,-110,9236,0,-69,-110,2.58368218,2.663676459,Michigan,Midwest
26077,122381,69689,7.6,30.98399851,22.50206267,5.670683602,40.84325522,732,630,-78,7297,5,102,-73,2.582371595,2.65295691,Michigan,Midwest
26081,329277,76923,7.9,29.11378057,23.53753279,7.716930275,39.63175637,2104,1371,-467,12071,23,733,-444,2.578086015,2.651979991,Michigan,Midwest
26087,35581,72737,12.2,35.52670588,37.00126391,7.667701718,19.80432849,196,273,19,1615,0,-77,19,2.593055909,2.6685061,Michigan,Midwest
26091,41555,67486,9.2,33.24222459,35.86184078,8.62272348,22.27321115,248,276,-84,4893,2,-28,-82,2.551504385,2.656287047,Michigan,Midwest
26093,92130,101227,8.6,32.3985757,24.55204565,3.848903888,39.20047477,439,477,97,1392,0,-38,97,2.563118508,2.645769154,Michigan,Midwest
26099,390375,73927,11.8,34.55745865,29.02852725,9.24475797,27.16925613,2307,3196,-352,7673,44,-889,-308,2.588922185,2.66874087,Michigan,Midwest
26103,29064,61598,8.6,33.03028939,26.64161303,4.496151942,35.83194563,148,143,-26,4126,0,5,-26,2.557994698,2.630448858,Michigan,Midwest
26107,16645,56096,9.5,32.35250187,36.6579537,8.267363704,22.72218073,111,110,79,1003,0,1,79,2.601815298,2.688642301,Michigan,Midwest
26111,36313,77595,7.9,31.23929471,27.44584383,4.965575147,36.34928631,182,207,-3,1097,0,-25,-3,2.547193563,2.610393861,Michigan,Midwest
26115,67687,72166,9.2,35.17958378,33.166398,8.244733839,23.40928438,403,453,97,1498,0,-50,97,2.54932562,2.635137798,Michigan,Midwest
26121,68576,58303,11.9,36.35315339,34.69512145,7.506033325,21.44569184,495,543,36,4756,1,-48,37,2.579103717,2.64127995,Michigan,Midwest
26125,594036,90801,9.1,26.94296538,17.78035547,5.068500367,50.20817878,3195,3749,-1668,14108,144,-554,-1524,2.57474431,2.65408337,Michigan,Midwest
26137,10420,65915,10.6,35.19226568,32.90364868,6.057461219,25.84662443,63,75,53,313,0,-12,53,2.674006749,2.810972596,Michigan,Midwest
26139,148785,85968,7.1,30.42739449,26.15555392,5.895876516,37.52117507,750,580,446,9529,4,170,450,2.550019189,2.631647954,Michigan,Midwest
26145,76084,54064,10.3,34.83781908,32.78319694,8.932343901,23.44664008,515,692,-110,6063,1,-177,-109,2.560422591,2.615554756,Michigan,Midwest
26147,65931,64894,11.7,38.58214338,33.18413711,7.907979246,20.32574026,378,500,74,1454,0,-122,74,2.54903441,2.651499602,Michigan,Midwest
26149,26404,60489,9.4,32.87687833,36.30392632,13.69365002,17.12554532,174,164,-23,401,0,10,-23,2.641854831,2.651183362,Michigan,Midwest
26155,29750,61959,9.5,38.55917385,34.61973627,7.331673901,19.48941598,162,219,-36,465,0,-57,-36,2.470710006,2.638356047,Michigan,Midwest
26159,31815,61638,8.7,32.54481787,33.40501656,11.16735812,22.88280744,179,201,-8,447,0,-22,-8,2.543114038,2.587084578,Michigan,Midwest
26161,181098,80941,6.7,23.44654344,14.19284757,4.230103366,58.13050563,890,729,-628,24033,21,161,-607,2.566465293,2.642579588,Michigan,Midwest
26163,693214,55928,13.6,31.48957792,29.52247559,12.10050628,26.8874402,5508,7357,-2843,20627,143,-1849,-2700,2.607708611,2.672710048,Michigan,Midwest
27003,188030,92249,6.4,35.03581451,27.5191395,5.784381534,31.66066446,1033,671,107,3472,4,362,111,2.546501069,2.652263321,Minnesota,Midwest
27007,23396,59882,6.4,34.21699256,26.28828517,7.205398858,32.28932341,134,127,-7,2146,0,7,-7,2.480263945,2.586395477,Minnesota,Midwest
27013,38592,68279,5.4,35.69031816,24.80344853,5.020940998,34.48529232,195,145,13,4346,3,50,16,2.535504138,2.6092224,Minnesota,Midwest
27019,56643,117602,5.2,28.16647732,17.66743329,3.688104409,50.47798498,250,142,238,915,0,108,238,2.511082577,2.570707427,Minnesota,Midwest
27023,6445,61878,5.2,37.05577783,33.40786067,9.896446223,19.63991527,36,32,-2,390,0,4,-2,2.609923028,2.594397634,Minnesota,Midwest
27027,35002,79357,4.4,33.78543165,22.16857875,4.999626708,39.04636289,222,154,-49,3138,1,68,-48,2.525693699,2.622706203,Minnesota,Midwest
27035,30131,67373,7.3,37.73673758,28.25494973,5.431911714,28.57640097,165,160,156,1312,0,5,156,2.511161765,2.612138519,Minnesota,Midwest
27037,229771,97727,6.3,31.23843934,19.6523749,4.501061007,44.60812476,1192,795,-10,3996,20,397,10,2.526296317,2.616070244,Minnesota,Midwest
27043,6708,67302,6.2,37.10507722,33.38043807,7.953971939,21.56051277,31,41,-9,148,0,-10,-9,2.555252233,2.604793713,Minnesota,Midwest
27049,25292,82091,5.9,32.8101072,32.95735658,6.334668394,27.89786783,129,132,-13,763,0,-3,-13,2.508165947,2.664116009,Minnesota,Midwest
27053,667782,89418,6.6,25.4665296,15.17257956,6.035065467,53.32582538,3901,3012,-1378,29929,135,889,-1243,2.569140553,2.648200774,Minnesota,Midwest
27083,14004,70958,4.5,36.08738101,27.11740298,8.14620454,28.64901147,78,59,-105,928,0,19,-105,2.547300029,2.62107559,Minnesota,Midwest
27109,86831,88032,5.5,26.74970237,19.75901007,4.966809769,48.5244778,482,328,-38,3206,8,154,-30,2.514242251,2.574895098,Minnesota,Midwest
27111,29971,65076,5.5,38.48897536,28.10820826,6.033444506,27.36937187,150,188,34,1279,0,-38,34,2.099053781,2.278565104,Minnesota,Midwest
27119,15442,69538,5.7,36.99452502,28.1192969,6.786091634,28.10008645,90,83,-106,1253,0,7,-106,2.768615091,2.706061662,Minnesota,Midwest
27123,270020,75041,7,25.85651019,20.10111058,8.52544798,45.51693125,1810,1321,-1271,17789,100,489,-1171,2.539982761,2.639550743,Minnesota,Midwest
27131,35493,77962,5.4,30.32516931,32.9529641,7.022914927,29.69895167,184,149,-49,7274,2,35,-47,2.563166608,2.64323252,Minnesota,Midwest
27137,94222,63141,7.3,37.23122367,25.25230587,5.015710294,32.50076018,432,584,-57,8993,0,-152,-57,2.503294411,2.604745174,Minnesota,Midwest
27139,80150,115687,5.9,31.71191855,20.16370533,5.046915552,43.07746057,414,218,178,1318,3,196,181,2.540586672,2.614399648,Minnesota,Midwest
27141,50247,97999,6.2,38.3985302,27.86036898,5.615861594,28.12523923,300,137,211,2216,1,163,212,2.543310104,2.657258405,Minnesota,Midwest
27145,86381,72378,5.8,36.31334725,27.88595976,7.212619805,28.58807319,536,322,-77,7184,9,214,-68,2.54036344,2.633228588,Minnesota,Midwest
27147,19515,75474,5.5,33.78925441,30.18118933,6.347521912,29.68203435,92,88,-29,497,0,4,-29,2.393185361,2.361133676,Minnesota,Midwest
27163,137630,107649,5.7,28.70189066,18.67465005,3.745178952,48.87828034,696,485,541,3730,0,211,541,2.521440489,2.613104299,Minnesota,Midwest
27169,26982,65699,5,35.42908415,26.36351984,6.149458437,32.05793758,133,120,-42,3531,1,13,-41,2.555757541,2.676143439,Minnesota,Midwest
27171,72792,95259,5.6,34.13298511,26.80764127,5.050653973,34.00871964,452,208,240,1125,1,244,241,2.497778328,2.547771067,Minnesota,Midwest
28001,9310,39547,10.8,29.77069186,34.53892333,16.38618246,19.30420234,78,128,-61,1289,0,-50,-61,2.727595754,2.662005959,Mississippi,South
28003,14189,49627,6.2,30.04368629,34.94487206,16.57582692,18.43561473,102,112,-11,670,0,-10,-11,2.535451205,2.620278998,Mississippi,South
28011,10386,39984,8.6,31.81105548,24.87735801,16.76022859,26.55135791,98,122,-112,1498,0,-24,-112,2.629539418,2.70280908,Mississippi,South
28027,7256,36071,12.3,36.13060726,26.86908758,18.02715899,18.97314617,67,93,-125,558,0,-26,-125,2.696083902,2.717831419,Mississippi,South
28033,85721,79967,5.9,34.21335688,28.90512121,8.56558035,28.31594156,544,407,640,879,7,137,647,2.589140347,2.600688874,Mississippi,South
28035,29865,51344,8,33.73204228,27.64382001,9.161867392,29.46227032,272,224,-52,5798,1,48,-51,2.609538547,2.614815383,Mississippi,South
28045,17036,59874,8.3,34.42472641,30.72759539,10.25732032,24.59035788,105,142,112,219,1,-37,113,2.575242403,2.643232224,Mississippi,South
28047,78489,55916,9.3,34.98929427,28.70269274,10.8361811,25.47183188,573,584,126,4539,13,-11,139,2.600985255,2.632937359,Mississippi,South
28049,92647,47479,9.3,33.80081844,23.59565965,11.54455161,31.0589703,682,670,-923,8224,0,12,-923,2.584845377,2.594620807,Mississippi,South
28059,52312,61515,9.4,37.08792309,26.77548568,11.23773283,24.8988584,375,390,81,1146,9,-15,90,2.561693854,2.594428761,Mississippi,South
28067,23413,58000,7,35.06000686,32.00137159,12.91347583,20.02514573,210,226,-77,1806,0,-16,-77,2.520513372,2.583386761,Mississippi,South
28071,24724,61736,6,26.19047619,21.45277425,8.077691051,44.27905851,109,107,84,5641,-2,2,82,2.542957073,2.568838277,Mississippi,South
28075,27065,49351,7.4,35.90860073,27.61104442,14.78218406,21.69817079,200,321,-182,2853,5,-121,-177,2.553290586,2.557030509,Mississippi,South
28081,37570,58266,8,31.21475054,27.84707158,12.18908171,28.74909617,270,259,-66,1065,4,11,-62,2.563478729,2.599547077,Mississippi,South
28083,8741,35520,10.5,32.00931858,30.81537566,17.18695399,19.98835178,105,162,-93,899,1,-57,-92,2.412535106,2.50864789,Mississippi,South
28085,13256,48596,7.3,31.95949325,36.68528088,12.94799133,18.40723454,92,152,-27,478,0,-60,-27,2.552166603,2.622863511,Mississippi,South
28087,22625,49344,8.2,29.4625323,32.05167959,11.93023256,26.55555556,184,205,-90,1887,0,-21,-90,2.583653306,2.605941476,Mississippi,South
28089,48985,80641,6.4,25.91617736,17.41243167,7.82074644,48.85064453,292,299,78,2385,2,-7,80,2.571726345,2.586380712,Mississippi,South
28091,9293,44129,7,35.18154176,34.88344363,17.45662672,12.47838789,58,114,-13,590,0,-56,-13,2.500698043,2.465100742,Mississippi,South
28095,14117,51754,8.8,28.58107538,40.3224445,14.69992403,16.39655609,116,145,-16,445,0,-29,-16,2.746512549,2.730277053,Mississippi,South
28099,9313,50331,9.2,32.7604025,33.12483002,17.76992113,16.34484634,104,169,-37,488,0,-65,-37,2.624984933,2.691660233,Mississippi,South
28105,20156,47284,7.6,22.73348519,22.50569476,9.001518603,45.75930144,130,115,-108,5635,7,15,-101,2.521504265,2.531741813,Mississippi,South
28109,21303,55830,7.1,35.85235003,36.00379906,12.18522987,15.95862104,166,210,95,1134,0,-44,95,2.825490915,2.811086221,Mississippi,South
28113,13142,40945,8.8,32.69297939,34.39282804,17.03729577,15.87689681,117,177,-77,975,0,-60,-77,2.6656646,2.668012528,Mississippi,South
28121,70437,72906,5.2,34.94634891,22.60523518,9.661739186,32.78667672,401,352,29,5701,0,49,29,2.568659994,2.606798159,Mississippi,South
28129,6170,51746,5.7,31.11931119,37.13612136,17.70192702,14.04264043,39,46,-10,145,0,-7,-10,3.083630333,2.547520561,Mississippi,South
28149,18206,52117,8.6,33.45339482,28.12805063,11.94667923,26.47187532,121,141,-139,452,1,-20,-138,2.61057054,2.654629833,Mississippi,South
28151,14481,39690,10.6,26.17456635,32.50008656,20.79077658,20.53457051,140,173,-229,829,0,-33,-229,2.593938437,2.649220561,Mississippi,South
28159,6642,50082,8.6,28.36300692,36.70458292,16.36993076,18.56247939,51,58,-18,449,0,-7,-18,2.521859127,2.541048414,Mississippi,South
29019,91342,63981,4.3,23.43990789,20.1390488,5.416703569,51.00433974,521,316,143,10730,22,205,165,2.511289304,2.5819053,Missouri,Midwest
29021,41255,56751,5,28.23426573,38.22027972,10.1993007,23.34615385,282,220,-346,3949,3,62,-343,2.504473696,2.588420461,Missouri,Midwest
29023,16906,44853,6.3,29.47343012,39.78068209,15.51777648,15.22811131,128,130,-68,954,0,-2,-68,2.705002264,2.731021615,Missouri,Midwest
29027,20321,72398,4.5,30.53242982,34.79832204,9.306227815,25.36302033,140,119,18,3355,0,21,18,2.507042049,2.514240448,Missouri,Midwest
29029,17355,63703,7.1,32.83072035,35.06400072,7.644114032,24.4611649,89,138,123,602,0,-49,123,2.544261585,2.587469551,Missouri,Midwest
29031,38134,64118,5.2,26.88109199,32.07141645,7.17369582,33.87379574,234,231,79,4312,6,3,85,2.583277409,2.62467533,Missouri,Midwest
29037,50728,77805,5.4,32.65428241,32.16095103,6.334853663,28.8499129,297,255,290,937,0,42,290,2.508815304,2.58820101,Missouri,Midwest
29043,43180,73616,4.9,33.74201375,27.03113627,6.654266074,32.57258391,227,166,382,619,3,61,385,2.521708598,2.594212056,Missouri,Midwest
29047,127530,78930,6.1,31.64614187,26.77226635,5.576029482,36.0055623,736,464,488,2256,5,272,493,2.52930625,2.600578136,Missouri,Midwest
29051,36884,70837,4.5,26.68306698,29.45296802,6.396124016,37.46784098,195,159,-570,4765,3,36,-567,2.497114243,2.572736654,Missouri,Midwest
29071,49078,65779,6.2,34.48579757,33.60450139,8.951257542,22.9584435,268,276,162,1051,0,-8,162,2.498032145,2.54298589,Missouri,Midwest
29077,140916,55751,5.4,32.67541432,28.24137896,6.655329597,32.42787712,791,728,283,9674,5,63,288,2.524330033,2.610680689,Missouri,Midwest
29095,329479,62509,7.3,30.00873727,28.21810845,8.316162313,33.45699196,2230,1842,-288,11205,31,388,-257,2.567008055,2.629470887,Missouri,Midwest
29097,52375,53548,5.8,29.15307241,34.46437585,11.23573372,25.14681802,384,316,26,2423,7,68,33,2.550769513,2.617520043,Missouri,Midwest
29099,109125,78297,6.1,36.12326219,31.71242175,8.548910174,23.61540589,626,586,262,1783,0,40,262,2.581510401,2.666199935,Missouri,Midwest
29101,21651,60086,5.7,31.14392291,32.89710911,6.857320485,29.1016475,193,119,-78,3216,5,74,-73,2.624701688,2.641677766,Missouri,Midwest
29113,27125,77913,6.2,32.08477675,40.56726328,8.913106236,18.43485373,178,122,224,736,0,56,224,2.645416275,2.683996431,Missouri,Midwest
29127,13480,57635,4.9,25.42522298,39.18792782,9.645301805,25.7415474,68,80,-34,1139,0,-12,-34,2.546059342,2.64421598,Missouri,Midwest
29135,6763,64519,4.4,26.57281553,42.69902913,13.53398058,17.19417476,50,51,-211,890,0,-1,-211,2.782732445,3.144645529,Missouri,Midwest
29145,24926,57423,5.9,31.93926743,34.3944138,10.66298892,23.00332985,168,155,16,1028,1,13,17,2.558956284,2.654986966,Missouri,Midwest
29147,10185,57507,4.5,29.37185729,39.21302578,5.818501078,25.59661585,64,34,-217,1954,0,30,-217,2.482351673,2.582553356,Missouri,Midwest
29159,19095,58827,6.9,34.49574557,34.11214953,12.76328637,18.62881852,149,116,-21,995,1,33,-20,2.496832304,2.614408603,Missouri,Midwest
29161,18700,54740,4.8,27.04631363,33.00597025,8.404281626,31.54343449,98,113,-66,2859,4,-15,-62,2.505269857,2.618865408,Missouri,Midwest
29165,55324,93925,5.5,29.99264952,21.10791848,3.299699298,45.59973271,296,178,326,1232,3,118,329,2.540576667,2.589286317,Missouri,Midwest
29169,13641,61718,5.7,35.25133399,30.90439452,5.947727968,27.89654352,177,89,-91,10377,38,88,-53,2.735270279,2.751099208,Missouri,Midwest
29183,212593,98925,5.2,30.5360663,22.51768164,4.548473479,42.39777858,1034,885,917,5429,11,149,928,2.559710001,2.629603338,Missouri,Midwest
29187,24300,48574,7.1,33.9014749,36.83427551,13.28048625,15.98376334,168,178,-386,6915,0,-10,-386,2.623897737,2.693020619,Missouri,Midwest
29189,486284,79609,6.4,26.60089274,20.89554394,5.576535114,46.9270282,2600,3241,-776,20159,92,-641,-684,2.560910073,2.651925384,Missouri,Midwest
29201,18709,57678,5.4,24.92706267,39.8257284,13.57217878,21.67503015,109,125,-27,518,0,-16,-27,2.149611499,2.407673901,Missouri,Midwest
29213,22576,53009,12.9,32.0942813,33.23029366,9.29675425,25.37867079,142,160,15,2271,1,-18,16,2.552270802,2.637501073,Missouri,Midwest
29510,136427,52278,8.8,25.79560398,24.50450874,9.525643434,40.17424385,915,1004,-1049,11146,24,-89,-1025,2.563292121,2.629397896,Missouri,Midwest
30013,35799,59184,5.8,33.63448632,31.52641542,6.102219928,28.73687833,233,200,-62,3127,5,33,-57,2.560551716,2.65570039,Montana,West
30029,46034,66395,7.7,32.21661431,27.37163311,4.377607251,36.03414534,281,254,528,1195,1,27,529,2.548648862,2.659960382,Montana,West
30031,67567,83520,5,25.847281,18.17469841,2.835849176,53.14217141,287,133,497,4154,7,154,504,2.531977767,2.609103829,Montana,West
30041,7257,50518,4.9,31.73700489,33.90202534,8.779806445,25.58116332,53,36,-53,874,0,17,-53,2.605722557,2.636954508,Montana,West
30049,35032,72491,4.9,28.54286768,23.49618587,5.149556474,42.81138997,200,170,173,1521,1,30,174,2.521298445,2.621836917,Montana,West
30063,60696,68210,6.2,30.2087637,20.4753688,3.421877658,45.89398984,271,212,347,3121,12,59,359,2.500850559,2.602020988,Montana,West
30093,16280,58898,6.5,33.78173317,32.51855801,5.991879588,27.70782923,85,97,86,1017,3,-12,89,2.45979796,2.602462415,Montana,West
30111,79362,78216,5.4,31.70431283,29.64158079,4.73179279,33.92231359,463,379,380,3921,7,84,387,2.547571965,2.639725615,Montana,West
31001,16351,64212,4,37.80583284,25.24466628,8.132706988,28.81679389,97,96,-24,959,1,1,-23,2.529039054,2.640380722,Nebraska,Midwest
31019,26747,67809,4,34.50980392,24.32010202,6.532759445,34.63733461,172,91,12,2501,0,81,12,2.485004284,2.575781494,Nebraska,Midwest
31053,19593,68267,3.5,31.71358629,35.94451244,10.79559364,21.54630763,113,122,-46,747,0,-9,-46,2.519137537,2.574612109,Nebraska,Midwest
31055,287163,74424,5.1,28.94821939,20.29603822,8.519183026,42.23655936,1965,1193,-175,11848,60,772,-115,2.555102561,2.632182012,Nebraska,Midwest
31079,30379,66277,5.8,31.41363875,32.16884643,15.30420866,21.11330616,207,143,-186,1077,3,64,-183,2.517828267,2.566831403,Nebraska,Midwest
31109,170896,68358,4.3,31.88831162,20.52446261,6.51269298,41.07453279,940,602,64,15033,17,338,81,2.509931673,2.586692549,Nebraska,Midwest
31111,17807,62442,4,43.65172791,29.37442193,6.558479778,20.41537039,69,109,-96,597,0,-40,-96,2.415983268,2.550655759,Nebraska,Midwest
31119,19058,63482,3.9,37.52958898,31.17279966,7.802883581,23.49472778,119,89,-88,1470,0,30,-88,2.465084721,2.541547908,Nebraska,Midwest
31141,17282,67132,3.7,35.11389013,30.58954891,10.20991514,24.08664582,105,70,-46,364,3,35,-43,2.512202585,2.667356199,Nebraska,Midwest
31153,93916,98619,4.1,33.87054434,19.93461193,4.326590354,41.86825337,619,298,183,1313,0,321,183,2.542197065,2.581826725,Nebraska,Midwest
31157,17521,56853,4.2,36.27889788,27.3108036,10.50794563,25.90235289,84,93,-33,944,0,-9,-33,2.662712854,2.690848973,Nebraska,Midwest
32001,10434,70149,5.8,40.21089433,33.20175933,7.979023345,18.608323,63,78,72,428,0,-15,72,2.728372562,2.730305089,Nevada,West
32003,934905,70838,15.5,31.89142926,27.6138789,13.18611005,27.30858179,6084,4841,8305,19976,132,1243,8437,2.623490563,2.67042766,Nevada,West
32005,20175,91960,9,37.51497082,24.1750121,6.258440996,32.05157608,85,140,102,223,0,-55,102,2.672281316,2.759491756,Nevada,West
32007,24606,88757,6,36.77247921,32.90379725,12.7860796,17.53764393,161,94,-97,648,0,67,-97,2.636868284,2.706218823,Nevada,West
32019,20664,74741,9,38.21813642,32.24605607,12.33004199,17.20576552,153,182,281,255,0,-29,281,2.615327955,2.634554329,Nevada,West
32023,15639,51933,10.2,38.46525097,35.51640927,13.34459459,12.67374517,93,216,565,1293,0,-123,565,2.585951154,2.745983211,Nevada,West
32031,228136,80245,8.2,32.03495681,23.4710016,11.31114111,33.18290048,1241,1090,1037,7263,5,151,1042,2.625140061,2.689722295,Nevada,West
32510,23415,62859,8.7,37.3093979,27.27833242,10.90611587,24.50615381,135,221,122,3427,0,-86,122,2.589600642,2.696822124,Nevada,West
33001,28824,77531,7,31.70606793,29.52636539,6.192895481,32.5746712,123,204,158,975,0,-81,158,2.529471698,2.626666562,New Hampshire,Northeast
33005,37222,76227,6.2,27.31287899,31.3603041,6.011403747,35.31541316,154,187,114,4136,0,-33,114,2.558842522,2.656884558,New Hampshire,Northeast
33009,45149,81205,5.9,23.24276791,25.81417915,6.105585542,44.8374674,169,220,109,7444,5,-51,114,2.539595274,2.596189618,New Hampshire,Northeast
33011,223541,96415,7,26.77104167,25.59428178,7.014328339,40.62034821,1022,1107,-158,8385,60,-85,-98,2.550701944,2.641288264,New Hampshire,Northeast
33013,77741,84898,5.8,27.42945869,28.20581464,6.284913708,38.07981296,326,370,236,8198,12,-44,248,2.531997847,2.629903221,New Hampshire,Northeast
33015,173201,107445,7,26.32501542,24.99882996,3.895590019,44.7805646,680,756,428,2373,9,-76,437,2.52101003,2.603069403,New Hampshire,Northeast
33017,68752,82845,6.3,30.01717769,26.1448989,5.343048648,38.49487476,304,309,145,8545,2,-5,147,2.544221384,2.629661519,New Hampshire,Northeast
34001,102446,76108,17.1,25.5560166,32.13900415,11.1436722,31.16130705,693,952,-154,5676,3,-259,-151,2.573594068,2.647736746,New Jersey,Northeast
34003,449064,113885,9.2,20.23696312,20.06210109,7.085893234,52.61504256,2202,3583,-914,10591,127,-1381,-787,2.554207596,2.613567642,New Jersey,Northeast
34005,219308,100188,7.9,26.29255306,26.11125834,5.599959043,41.99622955,1057,1508,107,11588,6,-451,113,2.558630833,2.612791033,New Jersey,Northeast
34007,237908,81372,9.7,25.45804516,29.10117255,10.16523821,35.27554408,1421,1714,-256,6450,17,-293,-239,2.583198552,2.645176694,New Jersey,Northeast
34009,39457,80845,13.7,25.53915223,31.65229845,5.361225108,37.44732421,196,398,-34,1462,4,-202,-30,2.585297649,2.626778131,New Jersey,Northeast
34011,61223,60892,10.4,24.19530188,39.13414871,18.72840225,17.94214716,424,538,-326,10729,3,-114,-323,2.61510317,2.652493538,New Jersey,Northeast
34013,343775,74747,11.2,21.24280367,27.66585415,13.20340007,37.88794211,2439,3606,-1870,25727,169,-1167,-1701,2.598249155,2.644129928,New Jersey,Northeast
34015,142271,97851,8.9,27.12149042,31.09181556,6.003673576,35.78302044,674,903,432,7746,2,-229,434,2.544793256,2.608104325,New Jersey,Northeast
34017,335061,82361,10.2,17.29384082,22.69232488,12.11083758,47.90299672,2381,2478,-3062,8195,186,-97,-2876,2.564757226,2.622822434,New Jersey,Northeast
34019,61260,137334,6.9,20.36538298,18.93926542,4.195648486,56.49970311,268,390,-49,3595,0,-122,-49,2.544703203,2.614354769,New Jersey,Northeast
34021,195728,94832,7.2,20.49559009,24.52982133,10.07440402,44.90018457,1014,1327,-606,19502,30,-313,-576,2.557258564,2.614954437,New Jersey,Northeast
34023,409340,102073,8.5,20.80356887,23.36949663,10.69938696,45.12754754,2233,2891,-1328,22968,113,-658,-1215,2.57171452,2.617325779,New Jersey,Northeast
34025,307993,117699,8.5,22.21665997,21.36717232,5.814895565,50.60127215,1468,2251,-119,6891,5,-783,-114,2.552315824,2.610836603,New Jersey,Northeast
34027,241666,131562,7.5,18.90535868,18.95448286,4.89282373,57.24733474,1161,1869,-252,8526,31,-708,-221,2.561247876,2.606512938,New Jersey,Northeast
34029,263012,81152,9.1,26.56188704,33.08381458,6.658090885,33.6962075,2363,2756,1649,6945,5,-393,1654,2.578340415,2.633025106,New Jersey,Northeast
34031,222385,78779,12.1,21.11871357,33.67745986,14.89275923,30.31106734,1613,2121,-1198,10479,86,-508,-1112,2.615838157,2.664819452,New Jersey,Northeast
34033,27781,76005,9.2,27.46511474,38.64823755,9.908956639,23.97769107,167,258,84,816,0,-91,84,2.561755054,2.65774166,New Jersey,Northeast
34035,161076,134735,7.5,18.52497382,17.97345509,6.15057934,57.35099175,761,1141,-284,4061,34,-380,-250,2.567180527,2.626560441,New Jersey,Northeast
34037,69295,111308,9,27.7577983,27.69155058,4.578664446,39.97198667,327,547,-99,1258,0,-220,-99,2.556288984,2.622981995,New Jersey,Northeast
34039,258049,96483,9.5,20.99432095,26.71767061,13.72420998,38.56379846,1626,2305,-1123,5520,80,-679,-1043,2.587662038,2.644253621,New Jersey,Northeast
34041,52883,97729,8.2,26.76232377,30.79442056,6.013148685,36.43010699,234,430,41,1670,0,-196,41,2.540122507,2.622226159,New Jersey,Northeast
35001,302519,65034,7.6,30.66086902,22.30530317,9.590970826,37.44285699,1608,1699,234,11174,75,-91,309,2.628168466,2.685726941,New Mexico,West
35005,25396,47855,7.6,35.19016885,27.55245421,19.05737217,18.20000476,177,188,-14,2101,1,-11,-13,2.663532807,2.671566533,New Mexico,West
35009,20702,52463,5.2,34.27483232,26.59004348,17.8435404,21.29158381,216,111,-167,833,6,105,-161,2.575344153,2.650442786,New Mexico,West
35013,88977,52011,7.8,28.41510612,22.84071188,17.34546432,31.39871768,560,473,329,4605,36,87,365,2.65061814,2.684075774,New Mexico,West
35015,30794,65063,6.5,37.19636008,27.28936352,15.69276278,19.82151362,199,135,-63,945,1,64,-62,2.7537153,2.807690139,New Mexico,West
35017,10738,47099,8.4,33.96016091,26.95197014,10.33780837,28.75006058,59,101,56,661,0,-42,56,2.574211364,2.674619946,New Mexico,West
35025,25917,59194,10.4,27.69216699,32.61237368,24.41812611,15.27733321,277,137,15,2104,6,140,21,2.744872543,2.739086461,New Mexico,West
35028,9413,139217,3.5,19.89354152,10.17033357,1.689141235,68.24698368,36,37,-7,65,2,-1,-5,2.530057327,2.624157796,New Mexico,West
35029,8576,38796,15.3,26.1167125,35.06263367,24.09410327,14.72655057,99,80,7,788,1,19,8,2.632942561,2.588906271,New Mexico,West
35031,21198,43720,9.8,31.82704667,36.59190639,19.11927663,12.46177031,227,345,-192,875,0,-118,-192,2.743387768,2.672290594,New Mexico,West
35035,23128,52787,7.9,36.67350133,29.02308354,12.70807152,21.59534361,210,186,-25,3651,7,24,-18,2.700159478,2.760300699,New Mexico,West
35041,7342,47854,5.8,35.0950808,29.44379966,14.11481118,21.34630837,52,28,-61,1034,0,24,-61,2.662570386,2.671734814,New Mexico,West
35043,61017,82862,7.9,34.43726036,24.7810315,7.386662657,33.39504549,310,334,478,1050,3,-24,481,2.631721775,2.664758515,New Mexico,West
35045,45109,51898,9.4,39.44633656,30.35293237,13.554649,16.64608206,344,440,-205,1305,1,-96,-204,2.582976643,2.654217362,New Mexico,West
35047,9579,47675,7.7,33.67305954,25.8058038,14.28356261,26.23757405,51,82,-40,1059,0,-31,-40,2.527601606,2.732086742,New Mexico,West
35049,65291,72836,7.7,27.14848684,20.12917025,8.55689722,44.1654457,273,352,302,2661,11,-79,313,2.562744116,2.637380688,New Mexico,West
35051,3697,40420,8.7,38.59363113,35.25703728,9.814150636,16.33518096,24,66,36,174,0,-42,36,2.596749844,2.743291767,New Mexico,West
35055,13034,48462,10.9,29.82521941,26.46838197,6.646163079,37.06023554,58,73,-17,234,1,-15,-16,2.688869455,2.742775284,New Mexico,West
35061,27772,53275,7.7,33.77388685,31.33578085,14.08076814,20.80956415,191,189,149,2001,6,2,155,2.640389014,2.692426823,New Mexico,West
36001,148570,76997,6.9,26.42135127,21.58283857,6.842307981,45.15350218,765,861,-729,16738,18,-96,-711,2.538302491,2.610995266,New York,Northeast
36003,17943,55466,7.8,32.02416918,35.03860356,8.375293723,24.56193353,127,124,1049,4502,0,3,1049,2.185790027,2.621189714,New York,Northeast
36005,514858,45864,16,24.93919882,28.40430625,24.70036561,21.95612932,4391,7099,-8289,52840,294,-2708,-7995,2.584120025,2.576667195,New York,Northeast
36007,76645,60533,8.3,30.84963325,29.57518337,8.988386308,30.58679707,424,570,-392,11717,6,-146,-386,2.568946861,2.648842675,New York,Northeast
36009,30661,52383,9.1,28.42942722,40.11754257,10.7791447,20.67388552,220,218,-62,2742,0,2,-62,2.562072463,2.622499275,New York,Northeast
36011,33395,64129,7.6,33.98995962,31.05969661,11.07170141,23.87864237,186,214,-85,3633,0,-28,-85,2.602797147,2.665044409,New York,Northeast
36013,49387,55644,8.5,31.88631717,32.98993527,10.02631965,25.0974279,323,361,-225,5027,1,-38,-224,2.577705242,2.655255703,New York,Northeast
36015,32996,56664,8.4,31.05796209,32.94155889,9.115171423,26.8853076,206,237,-389,3845,0,-31,-389,2.567527576,2.648024687,New York,Northeast
36017,20716,60755,6.6,28.28920088,41.26236597,11.27006694,19.17836621,119,164,-103,831,0,-45,-103,2.693261184,2.783286445,New York,Northeast
36019,33432,65272,7.7,28.91539933,32.45423914,11.80948912,26.82087242,150,192,-104,5624,0,-42,-104,2.536764947,2.626297165,New York,Northeast
36021,29126,83533,6,25.3835602,28.04051915,8.483697373,38.09222328,115,216,-48,1746,0,-101,-48,2.560614237,2.631699979,New York,Northeast
36023,21093,58274,7.7,30.84137742,31.73820771,9.088108441,28.33230643,137,125,-78,3857,1,12,-77,2.616858541,2.662835511,New York,Northeast
36025,17692,61424,7,26.62002834,37.09857371,9.58598438,26.69541356,109,143,-51,2083,0,-34,-51,2.53592927,2.610146745,New York,Northeast
36027,134383,90740,7.3,27.01248936,25.069543,8.192355,39.72561264,669,810,-858,18475,0,-141,-858,2.603092301,2.677214496,New York,Northeast
36029,405707,69888,9.2,29.66755456,25.84115256,7.564461221,36.92683166,2416,3042,-1401,27279,55,-626,-1346,2.56890727,2.64461844,New York,Northeast
36033,17955,59192,8,29.66071322,33.88985126,12.67845409,23.77098142,122,121,-92,3961,0,1,-92,2.517264643,2.595568599,New York,Northeast
36035,21075,61512,8.3,31.47536688,35.86477987,11.50419287,21.15566038,113,181,-151,1509,0,-68,-151,2.532767951,2.594790926,New York,Northeast
36037,27513,68973,7.1,32.25126879,36.67767883,7.457148329,23.61390405,157,160,-84,2041,0,-3,-84,2.519498588,2.617440311,New York,Northeast
36039,18984,71433,8,27.13383525,32.73489424,11.19936019,28.93191032,110,131,-142,3122,0,-21,-142,2.428352615,2.560333936,New York,Northeast
36043,25851,62197,7.9,35.05918539,34.02460621,8.299934756,22.61627365,143,174,-79,1317,0,-31,-79,2.597250501,2.652499815,New York,Northeast
36045,40513,58763,8.4,33.54679671,32.08247367,8.696176415,25.6745532,495,244,-810,6871,6,251,-804,2.588636636,2.656597519,New York,Northeast
36047,1052319,73244,12.5,18.72805051,24.12979549,15.81623574,41.32591826,8395,11048,-14297,45983,255,-2653,-14042,2.568727466,2.611963248,New York,Northeast
36051,28277,75077,6.8,30.63607375,31.34335515,7.422858376,30.59771272,144,141,-224,4586,0,3,-224,2.627088431,2.674368909,New York,Northeast
36053,30557,69851,7.5,31.46335641,33.80064672,6.718895809,28.01710107,146,157,-78,4923,0,-11,-78,2.478312113,2.59006738,New York,Northeast
36055,336893,68169,8.2,27.7097329,22.88898813,8.224741308,41.17653766,1941,2014,-1754,27671,32,-73,-1722,2.559912271,2.639771273,New York,Northeast
36057,20618,58176,8.4,32.6019633,35.40668459,11.47598457,20.51536754,155,140,-61,1202,0,15,-61,2.605207159,2.638646124,New York,Northeast
36059,655369,135528,8,22.42935272,21.00272425,7.854121143,48.71380189,3362,5696,-2883,21734,54,-2334,-2829,2.553123094,2.555837752,New York,Northeast
36061,811056,95514,9.5,13.3596683,11.81075,10.82679852,64.00278318,3706,5457,-13387,77568,193,-1751,-13194,2.57906711,2.582758281,New York,Northeast
36063,89502,63565,10.1,32.44058945,32.42746729,7.968428097,27.16351516,502,751,-306,3913,0,-249,-306,2.579962206,2.663332065,New York,Northeast
36065,94725,63894,7.8,31.08965292,30.09197267,11.06815281,27.7502216,659,806,-789,11961,3,-147,-786,2.567129844,2.633267593,New York,Northeast
36067,206935,70939,8,29.21300915,24.39708581,8.255736615,38.13416842,1231,1294,-1997,19888,4,-63,-1993,2.579103445,2.646849879,New York,Northeast
36069,51990,76601,7,30.25051518,25.90436229,6.673784045,37.17133848,237,290,-80,4000,0,-53,-80,2.54560715,2.612434493,New York,Northeast
36071,172265,88532,8,29.41515358,28.0189613,10.32354852,32.2423366,1325,1163,-494,13741,3,162,-491,2.594276788,2.657016428,New York,Northeast
36073,16007,62900,8.1,28.07601276,41.14842383,13.27479162,17.50077179,102,149,-155,2125,0,-47,-155,2.597710991,2.680128655,New York,Northeast
36075,48538,59335,8.6,31.38968785,36.69268985,9.993400819,21.92422148,296,268,-141,4722,0,28,-141,2.558656819,2.644382184,New York,Northeast
36077,25275,68962,6.9,27.56942675,30.69808917,7.880254777,33.8522293,125,180,-103,5817,0,-55,-103,2.550358357,2.59640688,New York,Northeast
36079,47668,112167,7.2,24.91953506,24.80287847,6.733755921,43.54383055,215,294,12,2320,0,-79,12,2.599670481,2.653226285,New York,Northeast
36081,1000240,80180,12.4,21.81213646,25.61868659,17.30803093,35.26114602,6240,10534,-11650,35116,232,-4294,-11418,2.595078051,2.616754853,New York,Northeast
36083,76661,80040,6.7,29.9889795,25.46352215,7.275292043,37.2722063,398,412,-255,6955,0,-14,-255,2.553391823,2.647733973,New York,Northeast
36085,198280,91582,10.5,23.35558695,29.40517411,11.46370132,35.77553762,1297,1932,-603,7317,7,-635,-596,2.592708758,2.653829793,New York,Northeast
36087,144312,99839,7.7,23.95035332,21.62957707,12.30044968,42.11961993,1400,1356,-941,6483,5,44,-936,2.545690449,2.629553583,New York,Northeast
36089,40394,59451,7.9,30.70418183,33.76645268,10.88932279,24.6400427,277,250,-201,10883,0,27,-201,2.60063945,2.664992891,New York,Northeast
36091,113947,93341,6.4,26.07048806,24.39065418,5.772688778,43.76616898,509,512,225,3948,0,-3,225,2.553767546,2.62782923,New York,Northeast
36093,72431,74206,7.7,30.49711193,26.28735162,8.156638013,35.05889844,440,476,1494,4582,1,-36,1495,2.567587264,2.64793389,New York,Northeast
36101,39426,60558,7.9,30.83872137,34.93262433,8.207444559,26.02120974,237,280,-205,1463,0,-43,-205,2.580946581,2.654538981,New York,Northeast
36103,718094,119253,8.1,25.80418522,24.81767442,9.516339698,39.86180066,3913,5670,-2295,29776,84,-1757,-2211,2.56515823,2.576644149,New York,Northeast
36105,33513,63733,8.4,28.15767293,29.81115834,12.34554617,29.68562257,208,273,-94,4440,2,-65,-92,2.691694196,2.693943277,New York,Northeast
36109,46779,72025,5.8,20.30594661,16.32311344,4.121013103,59.24992685,176,155,-4791,14475,5,21,-4786,2.52252521,2.602056584,New York,Northeast
36111,80952,79340,7.7,26.72771264,27.96947701,8.252372976,37.05043737,360,541,-365,11370,0,-181,-365,2.62383465,2.702137538,New York,Northeast
36113,28911,69849,8.1,29.2376482,28.0297819,8.117185287,34.61538462,106,200,-45,1075,0,-94,-45,2.549657055,2.655694132,New York,Northeast
36115,25748,67013,6.9,29.21455092,39.87137553,9.684405941,21.22966761,141,181,-152,3021,0,-40,-152,2.606191836,2.682373285,New York,Northeast
36117,40589,70917,7.1,34.30214771,31.15860001,9.006914275,25.532338,234,219,-113,1197,0,15,-113,2.583420371,2.668524287,New York,Northeast
36119,448279,108037,8,18.92234962,17.92220906,10.64540836,52.51003296,2477,3751,-1866,24482,81,-1274,-1785,2.569032569,2.567020204,New York,Northeast
37001,73052,61034,7.1,32.10731101,28.72553277,11.4582003,27.70895592,437,486,594,6095,0,-49,594,2.57962896,2.63903736,North Carolina,South
37013,17598,54415,6.3,35.79264948,31.6998842,11.92174072,20.5857256,118,138,53,430,0,-20,53,2.733029531,2.675578886,North Carolina,South
37019,47121,73536,8.7,33.883889,26.22383582,6.670587032,33.22168814,221,416,1930,961,0,-195,1930,2.54478787,2.608359452,North Carolina,South
37021,122139,67906,8.2,24.99270319,22.68740446,7.695047565,44.62484479,583,740,382,8192,7,-157,389,2.554850514,2.644080781,North Carolina,South
37023,35731,60629,7.1,31.85427081,33.09705477,14.87781097,20.17086345,184,292,109,2861,0,-108,109,2.534868308,2.584614963,North Carolina,South
37025,99509,79649,6.8,29.28913592,24.86006613,8.189060425,37.66173752,646,444,1262,1811,2,202,1264,2.512483486,2.571999027,North Carolina,South
37027,31780,53586,7.8,32.51322615,31.68284623,17.21882651,18.5851011,183,255,22,1118,1,-72,23,2.676681497,2.752789159,North Carolina,South
37031,28347,67806,6.2,36.75483466,23.61140162,7.296202628,32.33756109,106,201,145,828,2,-95,147,2.59480134,2.658959271,North Carolina,South
37035,69544,63934,7.9,33.74514711,28.82018448,12.50121599,24.93345243,424,437,270,2850,2,-13,272,2.629941192,2.676258707,North Carolina,South
37037,32995,84516,5.3,24.34793158,18.03781564,9.613351588,48.0009012,196,209,456,802,0,-13,456,2.551379827,2.667188056,North Carolina,South
37045,43311,53170,7.7,32.56903282,33.8239121,12.53578141,21.07127367,262,323,354,2081,0,-61,354,2.544272575,2.613637768,North Carolina,South
37049,37123,63076,6.4,39.12683062,26.61828653,8.227047309,26.02783555,370,300,-431,3476,14,70,-417,2.578119827,2.619895637,North Carolina,South
37051,111805,58013,9.3,38.95733152,26.45322099,7.399905637,27.18954186,1304,761,111,14457,5,543,116,2.615016993,2.654320026,North Carolina,South
37055,17172,82052,9.8,30.0775357,22.34150791,4.771427569,42.80952882,80,84,137,266,1,-4,138,2.485600303,2.543598979,North Carolina,South
37057,71988,63590,6.9,34.50095254,32.47660068,12.30017394,20.72227284,425,529,357,1862,5,-104,362,2.577393088,2.653925226,North Carolina,South
37063,158074,79524,6.3,20.89402596,16.27503776,9.288325562,53.54261071,986,639,269,14363,62,347,331,2.57719297,2.631627399,North Carolina,South
37067,166480,62992,7.3,28.91742879,24.13229246,10.07775798,36.87252077,1071,934,358,10947,7,137,365,2.552076132,2.59858392,North Carolina,South
37069,28606,72415,6.7,33.94801685,29.32199348,12.33606232,24.39392735,184,167,573,1529,3,17,576,2.605538971,2.682536941,North Carolina,South
37071,98013,65430,7.9,33.08975219,28.99423359,11.94790346,25.96811075,649,643,563,3449,1,6,564,2.550733983,2.602590197,North Carolina,South
37077,27143,74120,5.7,31.91003539,30.67473456,13.38052289,24.03470716,130,161,73,4298,0,-31,73,2.715455876,2.859331958,North Carolina,South
37081,230345,63822,8.4,29.56123434,22.61506224,9.722025107,38.10167831,1496,1297,-1897,25498,50,199,-1847,2.598443135,2.63331161,North Carolina,South
37083,17614,44804,9,29.09697058,36.35309465,19.09262212,15.45731265,125,191,-34,1285,0,-66,-34,2.577313364,2.698448867,North Carolina,South
37085,47591,65242,7.4,35.78182465,28.95745603,11.3376518,23.92306752,455,319,1,3442,-1,136,0,2.583139761,2.602981583,North Carolina,South
37087,25920,62374,7.4,34.66218075,27.53972788,8.396284306,29.40180706,125,203,226,942,0,-78,226,2.565188455,2.554394516,North Carolina,South
37089,47671,65252,6.8,31.42423343,24.63069933,8.88376447,35.06130277,250,406,453,1346,0,-156,453,2.539660862,2.647065318,North Carolina,South
37097,81104,73446,7.2,30.7654284,27.1172858,8.78594967,33.33133613,443,465,1069,1720,4,-22,1073,2.511144901,2.579049874,North Carolina,South
37099,17663,58491,7.5,30.01427552,29.76088508,10.21770164,30.00713776,73,111,-672,4614,1,-38,-671,2.551193513,2.575895876,North Carolina,South
37101,91245,80612,6.2,34.33384602,27.51288872,10.52287625,27.63038901,606,442,1766,1718,8,164,1774,2.586356424,2.62620129,North Carolina,South
37105,23080,58244,7.9,36.6494657,26.87460042,14.86208786,21.61384601,206,168,101,1052,1,38,102,2.524739654,2.594379087,North Carolina,South
37107,25014,46410,6.1,33.97467824,32.6928622,17.52077381,15.81168576,156,205,-39,1377,1,-49,-38,2.589123846,2.549283126,North Carolina,South
37109,39845,78615,6.4,33.67397042,29.29325477,10.00583072,27.02694409,220,255,451,779,2,-35,453,2.604988887,2.658375277,North Carolina,South
37119,558343,80645,7.6,25.7895128,16.39698682,9.205017101,48.60848328,3524,1885,-509,17427,238,1639,-271,2.574754381,2.621551269,North Carolina,South
37125,36572,84458,7.2,31.84655713,19.97486758,7.265430764,40.91314452,290,314,624,1000,3,-24,627,2.543000729,2.611751001,North Carolina,South
37127,37891,55406,8.2,31.46935096,33.20612981,13.60126202,21.72325721,250,266,197,1623,0,-16,197,2.604063922,2.653124262,North Carolina,South
37129,109452,70995,7.1,30.77343197,18.02440326,6.435336321,44.76682844,516,543,655,5780,8,-27,663,2.551355717,2.619526256,North Carolina,South
37133,58076,62190,7.2,37.3215644,29.84805335,6.773035218,26.05734704,897,338,3047,24077,63,559,3110,2.630527841,2.666376852,North Carolina,South
37135,72017,87780,5.3,18.76105436,12.63814598,6.777862342,61.82293732,290,221,-4139,11429,10,69,-4129,2.528435497,2.585082577,North Carolina,South
37139,14868,59066,7.2,34.79177084,28.35202514,10.00071434,26.85548968,113,134,20,2478,1,-21,21,2.616277905,2.632928204,North Carolina,South
37147,79630,57319,6.7,32.38908619,24.6584738,9.086382171,33.86605784,448,380,24,5122,3,68,27,2.564635812,2.602312244,North Carolina,South
37151,58089,58037,7.2,31.33728773,34.99246151,16.04011268,17.63013807,388,478,356,1577,1,-90,357,2.554282742,2.617371889,North Carolina,South
37153,14656,44383,9,37.39163341,30.60066052,15.82152195,16.18618412,144,148,-38,962,0,-4,-38,2.432894298,2.517968123,North Carolina,South
37155,43916,39931,8.7,29.40965393,34.91308277,21.11796289,14.55930041,380,428,-166,3948,0,-48,-166,2.619750665,2.625865765,North Carolina,South
37157,34901,52494,8.2,33.64835895,34.61155228,15.61188442,16.12820435,245,332,168,964,1,-87,169,2.609322632,2.615761175,North Carolina,South
37159,57911,61105,7.9,34.21566522,32.32732527,11.93540198,21.52160753,408,462,321,4113,2,-54,323,2.572437781,2.622743497,North Carolina,South
37161,21499,53485,9.2,34.82842877,31.08467014,13.40274089,20.6841602,149,212,96,1188,0,-63,96,2.702768474,2.764184732,North Carolina,South
37163,25874,52248,5.8,32.72388436,35.7459454,15.70968067,15.82048957,189,163,-4,1156,2,26,-2,2.66079959,2.646208298,North Carolina,South
37167,26980,58642,6.2,35.79107687,31.64307472,12.86731769,19.69853073,136,210,216,2026,0,-74,216,2.583766046,2.657888543,North Carolina,South
37171,29471,49524,6.8,34.72627593,28.52212669,17.35031948,19.4012779,168,229,47,964,0,-61,47,2.763278761,2.706184549,North Carolina,South
37179,111959,95079,5.9,28.56438865,22.84986827,9.55831717,39.02742591,573,380,1018,2900,1,193,1019,2.533934621,2.585422356,North Carolina,South
37181,14850,49961,10,31.15337637,35.80875938,14.56290351,18.47496074,135,178,2,476,1,-43,3,2.556325774,2.541819172,North Carolina,South
37183,534103,97099,6.3,23.14772151,14.52538564,6.049982849,56.27691,3042,1553,-571,21152,145,1489,-426,2.550726006,2.621951146,North Carolina,South
37189,25317,57888,6.2,24.02628626,20.75332585,7.555698029,47.66468985,70,93,52,6988,1,-23,53,2.575607147,2.643687568,North Carolina,South
37191,46394,55635,6.3,34.66600352,30.40783534,13.59196062,21.33420053,356,411,-75,3947,5,-55,-70,2.599749206,2.63515092,North Carolina,South
37193,25530,48229,6.7,32.84267472,32.36459709,18.12501311,16.66771508,161,231,0,1049,1,-70,1,2.719839845,2.769400287,North Carolina,South
37195,30543,51535,8.7,29.92368951,34.23624841,15.57620887,20.26385322,233,278,33,965,0,-45,33,2.624377378,2.633100051,North Carolina,South
38015,48896,83111,4.2,33.75439647,22.71795256,4.805807079,38.7218439,308,208,14,4194,1,100,15,2.538938616,2.618465978,North Dakota,Midwest
38017,101236,70002,4.2,34.43400575,18.10997226,4.171101483,43.28492051,593,388,76,5757,17,205,93,2.522034781,2.616231007,North Dakota,Midwest
38035,35452,64914,4.4,37.28335069,21.27733426,4.278606965,37.16070809,229,142,-139,4227,2,87,-137,2.517759633,2.625970051,North Dakota,Midwest
38089,17063,86963,7,33.78751697,30.23364705,8.812099078,27.1667369,142,59,95,707,3,83,98,2.557066559,2.733598712,North Dakota,Midwest
38101,30118,72091,5.8,36.68609754,28.72994081,4.919988296,29.66397335,258,142,-133,1952,3,116,-130,2.577307651,2.62512465,North Dakota,Midwest
38105,20955,84145,9.4,33.22652606,33.67268303,9.357128372,23.74366254,199,43,73,516,2,156,75,2.511298447,2.577881635,North Dakota,Midwest
39003,43698,60384,8.6,31.71758515,40.74111972,7.607074989,19.93422014,293,284,-103,3533,0,9,-103,2.589641339,2.628328643,Ohio,Midwest
39005,24573,62037,6.5,25.4702805,43.41607302,9.049421193,22.06422529,136,133,13,1551,0,3,13,2.536027437,2.618677417,Ohio,Midwest
39007,40037,52468,8.3,29.3090379,42.23906706,12.48104956,15.97084548,261,312,-41,3342,0,-51,-41,2.591322477,2.637758435,Ohio,Midwest
39009,24340,48265,7.6,26.61935803,29.77418379,8.179992849,35.42646533,116,126,-52,8017,3,-10,-49,2.569118881,2.61503625,Ohio,Midwest
39011,22822,71669,6.9,31.3410617,41.49562904,6.407576333,20.75573293,140,130,22,466,0,10,22,2.527870413,2.608601258,Ohio,Midwest
39013,25615,55573,10.1,27.47752403,45.85305363,7.950811202,18.71861114,150,243,-111,3759,0,-93,-111,2.606700534,2.611718911,Ohio,Midwest
39015,17645,64034,8.3,26.08411062,45.90410735,12.23367698,15.77810506,132,147,0,509,0,-15,0,2.466034398,2.658339983,Ohio,Midwest
39017,179572,74841,7.3,26.63700063,32.014666,8.817891882,32.53044149,1167,956,147,12645,24,211,171,2.555490732,2.626108981,Ohio,Midwest
39021,18371,72784,7.2,29.79790584,42.919382,8.175294721,19.10741744,103,104,20,439,0,-1,20,2.659105945,2.669279061,Ohio,Midwest
39023,57526,57264,8.1,33.12386449,37.60286417,10.73741584,18.53585551,381,433,-60,2525,1,-52,-59,2.523416003,2.557160485,Ohio,Midwest
39025,98553,79492,6.9,28.59666714,31.86540337,8.145919878,31.3920096,524,493,48,2108,2,31,50,2.50979433,2.58922034,Ohio,Midwest
39027,16198,65927,8.4,31.24535513,40.30151821,8.3979191,20.05520756,130,126,-10,1293,0,4,-10,2.6195574,2.682478616,Ohio,Midwest
39029,42616,54167,9.4,28.99518135,44.65375322,10.31573775,16.03532768,213,394,-70,3729,1,-181,-69,2.552047133,2.63848283,Ohio,Midwest
39033,16798,55912,9.3,28.88533624,46.11041192,9.50032314,15.50392871,117,135,7,449,0,-18,7,2.583176276,2.622889986,Ohio,Midwest
39035,536505,60808,10.5,28.10967432,27.21711781,8.755747395,35.91746048,3292,3848,-1912,27312,102,-556,-1810,2.579007351,2.637954443,Ohio,Midwest
39037,23910,65643,6.7,28.78556911,45.42400632,9.307249322,16.48317525,146,158,17,623,0,-12,17,2.607721848,2.671047007,Ohio,Midwest
39039,16278,63904,8.2,32.8396187,39.36044966,7.68295925,20.11697239,113,98,-36,696,0,15,-36,2.537218619,2.600301519,Ohio,Midwest
39041,106035,121528,5.4,22.61283338,16.42422227,2.926302785,58.03664157,503,357,875,1873,7,146,882,2.591037164,2.658383545,Ohio,Midwest
39043,32680,67925,10.4,30.25838413,34.24740787,7.569200169,27.92500783,173,274,-48,1999,0,-101,-48,2.600266297,2.640340536,Ohio,Midwest
39045,73318,82447,6.6,29.31407152,32.79706695,5.980099775,31.90876175,400,399,518,3297,2,1,520,2.540836905,2.591578024,Ohio,Midwest
39049,646859,69762,7.6,25.24700645,24.00540952,8.77705463,41.9705294,4382,3091,-1364,31357,190,1291,-1174,2.579429183,2.64134716,Ohio,Midwest
39051,20038,75383,7.9,33.62454356,42.29601065,5.241784118,18.83766167,117,114,-68,354,0,3,-68,2.532814981,2.566719065,Ohio,Midwest
39055,43719,101636,6.7,26.01240478,26.48360582,8.779694698,38.7242947,240,258,-30,1198,1,-18,-29,2.597636378,2.685589527,Ohio,Midwest
39057,76863,82769,6.5,30.21374019,22.96003076,5.539243957,41.28698509,427,411,89,7803,2,16,91,2.554162423,2.617173577,Ohio,Midwest
39059,16667,56004,8.7,28.96915253,41.36753406,14.31382011,15.3494933,105,130,-5,503,0,-25,-5,2.614315685,2.658775798,Ohio,Midwest
39061,380346,67033,7.9,25.58917393,25.50836376,7.542817795,41.35964451,2579,2233,-879,21541,73,346,-806,2.554921857,2.634388725,Ohio,Midwest
39063,38608,72658,6.8,29.45410684,35.72039998,5.093187036,29.73230614,219,172,-61,1759,4,47,-57,2.561740865,2.642108049,Ohio,Midwest
39065,12791,58844,8.1,25.4601227,47.3738026,8.287590141,18.87848455,105,105,28,1804,0,0,28,2.605736714,2.625314752,Ohio,Midwest
39069,11949,72122,8.1,32.19443282,41.72771034,7.408957723,18.66889912,83,73,-9,320,0,10,-9,2.608238159,2.716838101,Ohio,Midwest
39071,15890,59464,8.7,30.89584458,40.35348084,13.14759849,15.60307609,126,134,43,402,0,-8,43,2.623521639,2.755810034,Ohio,Midwest
39077,24901,61482,9.5,28.92344017,44.78549181,9.346428213,16.94463981,148,162,-67,445,0,-14,-67,2.628806258,2.674890911,Ohio,Midwest
39079,11977,54893,8.7,23.80654948,47.03310431,12.54573035,16.61461587,77,111,41,299,0,-34,41,2.724234542,2.833459573,Ohio,Midwest
39081,24675,54272,10.1,30.75687177,41.56064093,7.125797907,20.55668939,164,225,-21,2381,0,-61,-21,2.57397393,2.61597241,Ohio,Midwest
39083,28988,68334,6.2,28.70118293,38.04659455,8.906931361,24.34529116,183,165,49,3537,0,18,49,2.614755934,2.630208053,Ohio,Midwest
39085,112219,76163,8.4,31.76212158,31.57146833,6.138797937,30.52761216,489,617,47,2460,2,-128,49,2.562467119,2.631271385,Ohio,Midwest
39087,21630,51062,8.5,28.72911842,42.72409205,9.968954812,18.57783472,176,230,-50,544,0,-54,-50,2.491443275,2.587609074,Ohio,Midwest
39089,84118,76596,6.6,30.03006663,33.83308955,6.856005201,29.28083862,464,448,207,3896,0,16,207,2.54484321,2.619556571,Ohio,Midwest
39091,20838,62449,8.2,30.56478405,44.00285652,7.135094855,18.29726457,143,124,-64,391,0,19,-64,2.596028192,2.694612844,Ohio,Midwest
39093,137501,67124,9.8,32.45322934,31.11536838,8.536070493,27.89533179,806,851,522,9203,3,-45,525,2.573540538,2.625052835,Ohio,Midwest
39095,186684,57971,10.3,32.5258462,29.94054176,9.033341772,28.50027026,1318,1506,-355,10367,12,-188,-343,2.591764846,2.638582921,Ohio,Midwest
39097,19246,78533,6,28.79162107,37.7864624,11.07081444,22.35110208,107,109,-3,5136,0,-2,-3,2.609311114,2.664160477,Ohio,Midwest
39099,89896,54774,10.2,28.93139022,36.32141341,8.386596701,26.36059967,554,986,-201,7235,2,-432,-199,2.581029001,2.628327644,Ohio,Midwest
39101,26100,59012,7.6,31.54939387,43.81352428,10.93869023,13.69839163,173,203,45,5562,0,-30,45,2.559014516,2.611359347,Ohio,Midwest
39103,88194,89108,7.5,29.26831148,29.00625092,5.478607379,36.24683022,385,438,166,1712,3,-53,169,2.533871386,2.619916134,Ohio,Midwest
39107,22129,72077,5.4,29.03848905,43.46830734,5.336958077,22.15624553,164,114,-49,533,0,50,-49,2.452349641,2.523749916,Ohio,Midwest
39109,49964,72887,7,29.99487873,37.88819876,7.19341326,24.92350925,293,259,119,959,1,34,120,2.54981936,2.602286397,Ohio,Midwest
39113,228600,62794,8.7,33.92513026,27.63570242,7.918047179,30.52112014,1495,1645,-224,13473,26,-150,-198,2.582721111,2.638607742,Ohio,Midwest
39119,37075,58791,7.8,28.07666329,41.93684566,9.662276258,20.32421479,264,257,9,1619,0,7,9,2.5386385,2.61714743,Ohio,Midwest
39123,18696,72780,9.1,30.35036018,35.2292076,5.884086444,28.53634578,86,150,-8,473,0,-64,-8,2.689261446,2.715858459,Ohio,Midwest
39127,14442,60448,8.5,26.31836136,46.89497903,11.74817771,15.0384819,109,101,22,316,0,8,22,2.353262502,2.540199909,Ohio,Midwest
39129,24456,75916,6.9,26.14818024,40.99268246,11.60215675,21.25698055,168,190,121,4341,0,-22,121,2.568366761,2.593484571,Ohio,Midwest
39133,78952,72965,7.3,25.61444326,35.79451864,7.069936252,31.52110186,326,424,88,7594,7,-98,95,2.578251201,2.649401676,Ohio,Midwest
39139,47036,54906,9,29.67831753,41.91001107,10.53027969,17.88139171,341,356,15,6983,0,-15,15,2.602388051,2.67712493,Ohio,Midwest
39141,32374,60352,8,26.7574194,45.04336371,11.09342409,17.10579281,191,252,6,5384,0,-61,6,2.608252668,2.638925296,Ohio,Midwest
39143,27555,62473,8.1,31.48143704,42.71280808,6.700424776,19.1053301,156,172,-27,852,2,-16,-25,2.608909274,2.628107022,Ohio,Midwest
39145,26552,48465,8.7,27.27897434,43.45905405,11.3109379,17.95103371,189,304,-60,3334,0,-115,-60,2.580975039,2.637000721,Ohio,Midwest
39147,24917,63221,8.1,29.44954128,43.07879115,6.759309228,20.71235834,153,171,-17,2437,0,-18,-17,2.61673979,2.678658628,Ohio,Midwest
39149,22086,72498,7.7,29.88763345,40.87838889,8.622031313,20.61194634,140,136,-86,480,0,4,-86,2.488755694,2.507189468,Ohio,Midwest
39151,168367,64557,8.1,30.81289771,36.99012681,7.214142925,24.98283255,948,1258,-107,7624,1,-310,-106,2.540249489,2.610913205,Ohio,Midwest
39153,245092,66034,8.3,28.42884882,29.17366841,7.111328314,35.28615446,1378,1751,-373,8861,24,-373,-349,2.586739649,2.654449505,Ohio,Midwest
39155,75837,54406,10.4,26.72903927,43.00039473,9.977077721,20.29348827,495,757,-143,3727,0,-262,-143,2.607641909,2.658367048,Ohio,Midwest
39157,41102,59626,7.5,24.24114473,45.09187583,11.0751427,19.59183673,265,297,-58,1050,0,-32,-58,2.577622136,2.641956951,Ohio,Midwest
39159,27794,104512,5.8,25.99177362,30.1319368,4.773999236,39.10229035,154,111,256,2898,0,43,256,2.549752809,2.597205091,Ohio,Midwest
39161,13702,59377,7,32.03387283,44.52573032,6.443854287,16.99654257,89,87,-20,369,0,2,-20,2.642894963,2.542647686,Ohio,Midwest
39165,112049,104523,6.4,24.71964372,24.61948454,4.973976498,45.68689524,559,479,746,5076,21,80,767,2.515427016,2.580170368,Ohio,Midwest
39167,24507,59196,8.6,35.19575378,37.04408276,7.057469645,20.70269382,126,198,-53,1325,0,-72,-53,2.512172961,2.597922424,Ohio,Midwest
39169,56758,70121,5.9,23.59471595,37.99960955,13.69037548,24.71529902,358,343,-25,4052,1,15,-24,2.515065364,2.609678082,Ohio,Midwest
39171,17334,60983,7.7,33.38230177,43.7816523,8.601693277,14.23435265,104,87,-46,998,0,17,-46,2.59689484,2.639935613,Ohio,Midwest
39173,64350,67254,7,29.42771771,28.38251353,4.825219301,37.36454946,312,352,3,6636,1,-40,4,2.579681628,2.620906806,Ohio,Midwest
40013,21229,53782,5.2,28.91084077,34.3455198,12.3558746,24.38776483,154,129,251,907,0,25,251,2.622699684,2.657813583,Oklahoma,South
40015,11212,51071,6.1,24.78943022,46.47949353,13.26176713,15.46930911,108,102,-44,3595,0,6,-44,2.45948723,2.788916658,Oklahoma,South
40017,72896,81761,6,33.12436824,27.28663767,7.834336428,31.75465767,469,250,1131,2290,4,219,1135,2.57482508,2.629749706,Oklahoma,South
40019,19785,56052,7.2,30.95415118,36.84944238,12.19330855,20.00309789,158,149,11,599,0,9,11,2.66270893,2.713979311,Oklahoma,South
40021,18454,49403,5.6,28.42778793,32.06777226,10.08749021,29.4169496,118,144,27,1879,0,-26,27,2.585355336,2.644947586,Oklahoma,South
40027,134411,70923,5.7,31.91197778,24.73598042,7.728882356,35.62315945,678,561,506,13155,8,117,514,2.56740619,2.629686513,Oklahoma,South
40031,44706,55600,6.8,33.447929,32.95389434,9.427403644,24.17077301,370,273,-158,9423,27,97,-131,2.643722905,2.71080176,Oklahoma,South
40037,28932,57545,6.7,31.73806066,40.34164247,9.519199742,18.40109713,177,192,90,731,0,-15,90,2.63308259,2.722838261,Oklahoma,South
40039,14238,54056,5.5,26.72035579,28.39112927,11.5631949,33.32532003,93,82,-79,1378,0,11,-79,2.690841394,2.721342075,Oklahoma,South
40041,17430,54799,5.4,29.29592483,38.93239146,12.55872847,19.21295525,79,177,94,549,0,-98,94,2.555073886,2.640148181,Oklahoma,South
40047,25442,55515,5.6,28.45755873,36.76510632,12.47617397,22.30116098,182,166,-164,1582,6,16,-158,2.521241352,2.623124673,Oklahoma,South
40051,24721,66930,6.3,28.98978194,39.56072896,9.509638681,21.93985042,153,135,42,1643,0,18,42,2.538986538,2.557792461,Oklahoma,South
40065,10160,53513,4.2,35.36140792,27.09616593,13.34380893,24.19861722,76,62,-61,712,1,14,-60,2.627422576,2.743130219,Oklahoma,South
40071,17066,53066,6.8,36.62929101,35.3769191,9.470415732,18.52337416,125,145,-73,1102,0,-20,-73,2.625428477,2.677586313,Oklahoma,South
40073,8359,73023,4.5,25.44294826,41.90543687,9.83092032,22.82069454,52,30,-30,266,0,22,-30,2.370796019,2.3921937,Oklahoma,South
40079,17826,47026,7.1,29.57010602,40.93311742,14.66894803,14.82782853,140,147,65,1667,0,-7,65,2.618994874,2.671773613,Oklahoma,South
40083,21130,76331,5.3,29.19098763,32.09491011,8.256479103,30.45762316,111,94,171,1958,0,17,171,2.560078328,2.591656944,Oklahoma,South
40087,18940,75474,5.6,29.44785276,31.15541922,11.35310157,28.04362645,97,88,253,316,0,9,253,2.591298445,2.621551105,Oklahoma,South
40089,13972,44465,6.8,28.67346436,41.5151963,14.29486232,15.51647702,120,108,9,291,0,12,9,2.826319765,2.785725026,Oklahoma,South
40097,18299,50174,5.2,33.47116592,39.41519604,10.6549509,16.45868714,102,141,45,420,0,-39,45,2.896871226,2.856987741,Oklahoma,South
40101,27291,53035,6.2,33.82050645,34.13449592,13.01588019,19.02911744,220,251,-81,3643,0,-31,-81,2.591892587,2.646693919,Oklahoma,South
40109,359437,61580,6.6,29.26193045,24.13517507,11.50812741,35.09476706,2656,1898,663,15978,58,758,721,2.576969057,2.627723252,Oklahoma,South
40111,14225,45754,7.5,36.62654496,34.25559415,11.81840213,17.29945876,110,135,-3,1314,0,-25,-3,2.564788209,2.452077081,Oklahoma,South
40115,13446,47855,5.8,36.95430956,35.31087819,12.76584919,14.96896306,80,107,-37,993,0,-27,-37,2.550920466,2.617205166,Oklahoma,South
40119,35635,51236,5.4,26.02706027,27.04237951,6.825450073,40.10511014,182,146,-65,9446,14,36,-51,2.55109261,2.600957522,Oklahoma,South
40121,15376,47930,7.8,31.85631106,35.70512188,12.73068193,19.70788513,123,150,31,2055,0,-27,31,2.650745527,2.668956531,Oklahoma,South
40123,18161,56077,5.3,28.47175421,32.24975223,9.546085233,29.73240833,110,117,19,728,0,-7,19,2.566932657,2.631579061,Oklahoma,South
40125,30266,52695,6.3,32.32586809,35.22087528,11.45469488,20.99856174,212,213,82,3444,0,-1,82,2.61234028,2.632900141,Oklahoma,South
40131,42104,72952,6,33.55525362,33.01328502,7.82910628,25.60235507,257,241,102,1786,0,16,102,2.678781299,2.734415665,Oklahoma,South
40133,8504,44114,7.6,32.8971724,37.25027127,14.73160146,15.12095487,59,101,-6,604,0,-42,-6,2.785210486,2.785149944,Oklahoma,South
40135,15373,47450,7,31.04086467,38.28842168,15.52043234,15.15028131,111,152,-2,411,0,-41,-2,2.482672344,2.534711042,Oklahoma,South
40137,17022,55309,8,28.04631258,40.76900109,11.69425737,19.49042896,114,128,-20,603,0,-14,-20,2.576318135,2.549890991,Oklahoma,South
40139,11013,60719,2.4,21.61884436,28.96213738,25.00197613,24.41704213,74,49,-116,368,7,25,-109,2.298638418,2.500101879,Oklahoma,South
40143,301882,63442,6.7,31.01192723,25.06232582,10.20990749,33.71583946,2064,1595,723,11946,47,469,770,2.566693409,2.632652514,Oklahoma,South
40145,36215,73851,5.9,34.18146571,30.68508326,8.27361789,26.85983314,200,173,396,284,0,27,396,2.549498587,2.679860556,Oklahoma,South
40147,20901,61704,6,27.79558951,33.23203881,8.514315983,30.4580557,147,155,168,1160,0,-8,168,2.542378187,2.640147768,Oklahoma,South
41003,44087,70117,5.6,27.6149783,14.04131481,3.98681156,54.35689533,154,141,-7,6486,9,13,2,2.559211588,2.632719453,Oregon,West
41005,202879,96915,7.2,33.7307498,21.25143252,5.329453844,39.68836384,1015,941,922,3917,7,74,929,2.594575632,2.670429343,Oregon,West
41007,17459,63667,9.5,40.86128711,25.68423761,7.1559515,26.29852378,98,93,85,508,0,5,85,2.51181078,2.635865808,Oregon,West
41009,22258,77572,7.9,38.40555311,32.81618276,9.603978347,19.17428579,143,115,98,502,0,28,98,2.521139964,2.578796174,Oregon,West
41011,24311,55983,8.6,38.78030349,30.54755632,8.980250393,21.69188979,130,216,138,1315,0,-86,138,2.606591138,2.743398662,Oregon,West
41017,90543,84281,7.9,32.00560674,19.38644683,5.242039951,43.36590648,462,375,1237,1698,0,87,1237,2.562129763,2.657656947,Oregon,West
41019,43706,55837,7.8,40.77917393,31.90284374,8.371310046,18.94667228,236,420,287,1657,0,-184,287,2.610321784,2.69028276,Oregon,West
41029,97012,68239,7.8,34.68895056,26.02075737,8.706771034,30.58352104,546,606,410,3268,1,-60,411,2.595869474,2.670904488,Oregon,West
41031,9482,65600,8.3,37.2816092,31.40804598,11.28735632,20.02298851,83,63,55,1095,0,20,55,2.494638115,2.58580287,Oregon,West
41033,33291,54983,7.9,39.16761774,31.35509397,9.763372137,19.71391615,195,288,259,1501,1,-93,260,2.557382076,2.691523277,Oregon,West
41035,26982,54961,8.7,34.4949147,33.58118238,10.41168605,21.51221686,203,224,151,1034,0,-21,151,2.585032959,2.664441884,Oregon,West
41039,165227,64192,7.9,36.89801302,22.81190167,6.857209231,33.43287609,775,949,414,13182,8,-174,422,2.566913746,2.654189561,Oregon,West
41041,18523,57216,10.8,39.07174276,23.87127762,8.246119622,28.81086,84,175,226,567,0,-91,226,2.594568246,2.704885583,Oregon,West
41043,54618,67265,7.7,41.50073544,29.00814472,8.716603368,20.77451648,358,387,409,1417,1,-29,410,2.597064377,2.642671262,Oregon,West
41045,11931,49380,5.3,36.23720301,32.11319297,16.19180993,15.45779409,105,86,49,3177,0,19,49,2.443533844,2.597926226,Oregon,West
41047,151468,70861,7,34.92758621,25.14008621,13.95,25.98232759,982,833,188,10667,9,149,197,2.603623368,2.68609332,Oregon,West
41051,417372,79432,8.6,27.08760092,16.54734171,7.746749943,48.61830743,1956,1470,415,22221,59,486,474,2.578507514,2.691268156,Oregon,West
41053,38053,77156,6.5,37.35920865,23.81580978,8.192899145,30.63208243,222,187,519,2081,1,35,520,2.599969411,2.702749538,Oregon,West
41059,34389,71012,6.8,34.65540274,31.77482173,15.57696288,17.99281266,239,174,-60,4554,0,65,-60,2.646646413,2.730975246,Oregon,West
41061,11084,57091,7.9,35.66995046,32.9650931,6.451796595,24.91315984,70,77,-24,359,0,-7,-24,2.573731432,2.646756681,Oregon,West
41067,300230,98706,6.5,29.20377566,17.01497367,7.091376755,46.68987391,1507,911,-168,7254,78,596,-90,2.575156844,2.668472161,Oregon,West
41071,50550,77969,6.8,34.89862267,25.60941062,10.24969985,29.24226686,254,249,194,5397,3,5,197,2.542213209,2.64238784,Oregon,West
42001,51147,76554,6.7,25.35097083,40.60587226,9.277250064,24.76590685,203,317,41,3518,1,-114,42,2.549186245,2.636946805,Pennsylvania,Northeast
42003,589554,71973,8.8,25.29983622,25.393221,4.530216806,44.77672598,3105,3604,-888,34544,63,-499,-825,2.570251892,2.629695715,Pennsylvania,Northeast
42005,28779,57609,9.6,25.66597938,48.53814433,6.93814433,18.85773196,141,212,-30,676,0,-71,-30,2.591049189,2.681899877,Pennsylvania,Northeast
42007,75522,67135,10.1,30.43556134,36.34942604,4.919807865,28.29520475,368,590,-154,2877,0,-222,-154,2.556511964,2.643755923,Pennsylvania,Northeast
42011,195790,72157,9.2,24.35317046,36.85712439,11.62031353,27.16939162,1097,1327,-88,12423,23,-230,-65,2.575756428,2.630656648,Pennsylvania,Northeast
42013,55160,57884,8.5,23.92142464,45.21181384,6.782403158,24.08435836,287,386,-82,4111,0,-99,-82,2.536861195,2.59228814,Pennsylvania,Northeast
42015,26491,63529,7.3,23.34344075,46.51293985,8.93448981,21.20912959,155,151,-16,636,0,4,-16,2.442260445,2.557015222,Pennsylvania,Northeast
42017,316977,105202,8.1,23.40384475,27.5386898,5.107825438,43.94964001,1421,2095,141,8860,16,-674,157,2.560479354,2.636570889,Pennsylvania,Northeast
42019,92204,81507,7.6,25.09796949,31.93627538,4.327015398,38.63873973,458,505,313,4969,0,-47,313,2.527365016,2.59160917,Pennsylvania,Northeast
42021,51879,54612,9.3,25.71446563,44.17459934,7.118942916,22.99199211,310,416,-166,6275,0,-106,-166,2.554594156,2.621106279,Pennsylvania,Northeast
42025,29015,64766,9.5,27.41627588,44.50139021,9.739801635,18.34253227,138,225,78,823,0,-87,78,2.599252719,2.672613784,Pennsylvania,Northeast
42027,73508,67654,5.7,19.62101248,28.45482604,5.42743763,46.49672385,266,285,-209,20014,24,-19,-185,2.499663733,2.577902931,Pennsylvania,Northeast
42029,268513,117326,6.2,18.99713714,19.33427686,5.086962137,56.58162387,1379,1309,145,13680,34,70,179,2.557341397,2.619901032,Pennsylvania,Northeast
42033,33032,59318,8.9,23.89694644,46.47939948,9.566590809,20.05706328,152,239,-49,5753,0,-87,-49,2.423411374,2.545987244,Pennsylvania,Northeast
42035,16415,58892,8.5,22.61766705,45.77118407,10.32111009,21.29003879,110,112,-73,1392,0,-2,-73,2.699885209,2.665063769,Pennsylvania,Northeast
42037,31233,59127,7.9,22.09498609,44.83553082,8.191523336,24.87795976,131,202,16,3585,0,-71,16,2.601100272,2.664696617,Pennsylvania,Northeast
42039,35441,54774,8.7,22.98367902,46.81740904,8.97483849,21.22407344,197,210,-118,3878,0,-13,-118,2.570639051,2.666440633,Pennsylvania,Northeast
42041,124976,81295,6.5,23.2642946,30.62450069,6.5482628,39.56294191,704,623,674,12483,0,81,674,2.528001775,2.60292311,Pennsylvania,Northeast
42043,134329,67813,8.7,25.11264478,32.07732519,8.520406373,34.28962365,889,786,104,6617,10,103,114,2.541319934,2.609810793,Pennsylvania,Northeast
42045,273188,83856,9,24.77681015,27.22037945,6.405873323,41.59693707,1633,2097,-193,20874,31,-464,-162,2.566429818,2.631687897,Pennsylvania,Northeast
42049,116813,56489,9.6,25.43617358,37.51870465,7.418034765,29.62708701,635,753,-241,12459,2,-118,-239,2.560332169,2.633836499,Pennsylvania,Northeast
42051,50439,51494,11.5,23.53186217,47.49524684,10.04251138,18.93037961,299,411,-136,3966,0,-112,-136,2.623245591,2.688650112,Pennsylvania,Northeast
42055,72991,73709,7.4,23.38687056,43.32534045,9.335384337,23.95240465,400,452,3,1337,6,-52,9,2.579182691,2.660167575,Pennsylvania,Northeast
42061,17845,58170,10.2,22.42153875,50.08953536,9.29911093,18.18981496,96,110,-31,4926,0,-14,-31,2.506013161,2.648576411,Pennsylvania,Northeast
42063,35017,53040,8.8,25.32496145,40.12264082,7.633840053,26.91855769,195,245,-47,5694,0,-50,-47,2.571483581,2.600915358,Pennsylvania,Northeast
42065,18687,54248,8.5,22.29489459,51.61290323,8.601092202,17.49110998,111,115,-17,660,0,-4,-17,2.558485125,2.719461923,Pennsylvania,Northeast
42069,95479,61168,9.4,26.07953688,35.42797508,8.356688567,30.13579947,567,898,-98,8259,4,-331,-94,2.587745254,2.668595165,Pennsylvania,Northeast
42071,265741,82434,7.3,21.71595972,34.45719371,12.85168645,30.97516012,1628,1682,-238,14273,13,-54,-225,2.546555426,2.621011916,Pennsylvania,Northeast
42073,36779,58730,10.1,26.35180159,43.24789936,7.620796697,22.77950235,228,325,-22,2016,0,-97,-22,2.569036471,2.613993338,Pennsylvania,Northeast
42075,67617,69490,7.7,22.47060605,41.62284907,11.9543826,23.95216228,382,458,54,3086,5,-76,59,2.504262581,2.536937954,Pennsylvania,Northeast
42077,177177,72590,9.3,24.75677102,32.15822787,9.706650523,33.37835058,1013,1198,-41,7709,46,-185,5,2.593142991,2.650274644,Pennsylvania,Northeast
42079,142862,59358,10.7,28.55868858,37.13159425,9.324688193,24.98502897,766,1256,3,11100,7,-490,10,2.601057983,2.667487591,Pennsylvania,Northeast
42081,52070,61729,8.6,27.88953205,38.44749772,8.86394039,24.79902984,285,341,-31,5187,1,-56,-30,2.560471049,2.637380681,Pennsylvania,Northeast
42083,15717,58112,9.6,25.34442968,46.82145605,7.48653752,20.34757675,107,120,-27,2544,0,-13,-27,2.619799726,2.579366925,Pennsylvania,Northeast
42085,44240,57702,9.4,25.76067486,40.4685376,8.694878864,25.07590868,272,339,-57,5977,0,-67,-57,2.56521025,2.620772425,Pennsylvania,Northeast
42089,73723,79824,11.2,26.97193155,35.46428601,9.684073391,27.87970904,370,478,63,3550,2,-108,65,2.602816054,2.658520441,Pennsylvania,Northeast
42091,422938,106743,7.4,20.63295929,22.01767087,5.096745533,52.2526243,2161,2747,733,22327,50,-586,783,2.563768152,2.645111179,Pennsylvania,Northeast
42095,147814,75468,8.7,25.96958055,32.917772,7.344986466,33.76766098,696,1066,102,11589,7,-370,109,2.566296309,2.636398082,Pennsylvania,Northeast
42097,39016,57822,9.1,23.18403481,47.65548803,9.987245855,19.1732313,211,298,-34,3562,0,-87,-34,2.700909862,2.731926634,Pennsylvania,Northeast
42101,648448,56385,12.2,22.9453731,29.81186792,12.60348091,34.63927807,4897,5480,-3242,46724,272,-583,-2970,2.595845457,2.654740888,Pennsylvania,Northeast
42107,61142,63680,9,25.81908217,45.05575709,10.00460644,19.12055431,325,509,54,6994,0,-184,54,2.543722433,2.598650071,Pennsylvania,Northeast
42111,30203,50516,9.2,23.45991408,49.31005607,9.945022937,17.28500692,158,242,-48,4735,0,-84,-48,2.514530936,2.586121342,Pennsylvania,Northeast
42119,18346,65521,6.6,18.932172,41.3277553,13.3152733,26.4247994,103,115,-27,7339,-1,-12,-28,2.554861513,2.63974244,Pennsylvania,Northeast
42121,20536,52449,8.7,25.50663871,46.37424071,8.466376391,19.65274418,102,143,-59,874,0,-41,-59,2.626633955,2.692754427,Pennsylvania,Northeast
42125,97382,70751,9.1,26.02712694,35.23213135,5.955560233,32.78518148,491,640,164,4876,0,-149,164,2.568765249,2.621229937,Pennsylvania,Northeast
42129,163499,71152,8.9,28.33373212,35.21710894,4.605375597,31.84378335,700,1140,35,6227,0,-440,35,2.539007652,2.610844132,Pennsylvania,Northeast
42133,218784,79938,7.8,26.14794374,38.01088269,8.630413797,27.21075977,1089,1151,167,8096,10,-62,177,2.577343573,2.657616017,Pennsylvania,Northeast
44001,24268,101158,7.4,20.87266802,20.89514498,6.478984041,51.75320297,95,139,24,3389,0,-44,24,2.543052653,2.602182406,Rhode Island,Northeast
44003,85412,84230,8.6,30.30222194,28.18855134,7.212685162,34.29654155,365,552,201,2062,0,-187,201,2.525130345,2.592167684,Rhode Island,Northeast
44005,41180,92795,8,22.63804547,19.65196378,4.661927851,53.04806289,163,188,-112,3787,3,-25,-109,2.566573486,2.645194046,Rhode Island,Northeast
44007,303203,74190,10,25.38875592,28.69299028,13.71724185,32.20101195,1738,2144,-621,29064,73,-406,-548,2.576248471,2.636751773,Rhode Island,Northeast
44009,64217,99015,7.6,24.57142232,20.20304791,4.744713206,50.48081657,185,366,78,7440,1,-181,79,2.572833171,2.655801399,Rhode Island,Northeast
45003,70326,67728,4.8,29.02711717,29.74673666,10.17325086,31.05289532,427,516,449,2704,5,-89,454,2.589284795,2.625039955,South Carolina,South
45007,83660,62708,5.7,30.9347581,30.47119539,12.17937496,26.41467155,499,629,595,3190,5,-130,600,2.5740172,2.625128064,South Carolina,South
45013,71015,83687,5.3,28.04115232,21.37482234,5.807787485,44.77623785,471,465,765,8292,22,6,787,2.575158524,2.620476033,South Carolina,South
45015,98848,79259,5.4,31.97444744,28.64848985,9.435318532,29.94174417,675,425,1515,4326,32,250,1547,2.586553856,2.636138635,South Carolina,South
45019,194389,79969,6.1,25.30120079,18.56641135,7.097702111,49.03468575,1186,907,1157,9109,37,279,1194,2.579680494,2.632627215,South Carolina,South
45021,22894,50403,7.8,30.18931711,36.91423519,14.49264056,18.40380715,142,179,13,1201,2,-37,15,2.53154514,2.514309164,South Carolina,South
45025,20120,44574,5.9,27.6357566,41.13776963,18.02559654,13.20087722,107,159,22,752,0,-52,22,2.614867656,3.034477244,South Carolina,South
45029,15331,47933,5.9,28.7502778,40.14741833,14.43440255,16.66790133,118,176,-21,416,1,-58,-20,2.765995914,2.663693993,South Carolina,South
45031,28052,50427,6.3,30.20331604,36.61541312,13.48184513,19.69942571,172,249,-1,1022,1,-77,0,2.617007899,2.62942868,South Carolina,South
45035,71796,74730,5.6,35.19399003,26.10202273,8.73649054,29.96749671,454,323,571,2015,13,131,584,2.590598293,2.650253927,South Carolina,South
45041,62096,52650,5.4,30.72886864,33.3578053,12.26693154,23.64639452,383,471,-164,3280,2,-88,-162,2.522431363,2.571807155,South Carolina,South
45043,23734,59457,7.3,32.02806096,27.39430986,8.08598798,32.4916412,130,219,219,599,0,-89,219,2.600356103,2.632676416,South Carolina,South
45045,238182,71833,5.5,27.6522075,22.80800531,9.507528777,40.03225842,1545,1240,1281,10444,73,305,1354,2.526441641,2.582676742,South Carolina,South
45047,28896,49867,6.2,30.47198336,32.83940557,11.12302447,25.5655866,191,220,50,2794,2,-29,52,2.55080005,2.604932986,South Carolina,South
45051,132675,61375,8.4,33.37523615,31.40688723,8.621866771,26.59600984,793,1055,3333,7181,19,-262,3352,2.572990109,2.620249315,South Carolina,South
45055,27447,61015,5.1,32.91177421,33.42023053,10.84132285,22.82667241,164,204,222,369,2,-40,224,2.531084984,2.613513647,South Carolina,South
45057,39537,70113,6.6,30.12144082,27.72555746,10.95849057,31.19451115,259,263,621,1933,3,-4,624,2.609841214,2.62823713,South Carolina,South
45059,27435,53847,6.7,28.64093072,37.20782655,16.28344791,17.86779482,160,226,158,1885,4,-66,162,2.535142394,2.627277659,South Carolina,South
45063,141926,73022,4.2,31.77170835,26.63514616,8.485095762,33.10804973,759,742,1050,2562,9,17,1059,2.564151679,2.602807987,South Carolina,South
45071,17997,55050,4.6,30.27766043,32.51276931,13.72940589,23.48016437,93,121,29,1458,0,-28,29,2.386148123,2.515903371,South Carolina,South
45073,32546,61716,5.2,28.34622807,30.27446158,12.86229099,28.51701935,167,207,234,703,2,-40,236,2.604757478,2.682342141,South Carolina,South
45075,31089,42209,8.8,30.5600793,33.39233874,16.6855484,19.36203356,198,328,-136,3621,0,-130,-136,2.650848209,2.675928435,South Carolina,South
45077,52908,55333,5.1,29.97547969,29.96238633,12.74817883,27.31395515,304,331,276,9037,4,-27,280,2.504381266,2.559354622,South Carolina,South
45079,183830,61010,5.7,29.83385106,21.01720157,8.032161741,41.11678563,1127,942,-720,26954,66,185,-654,2.546496632,2.569069319,South Carolina,South
45083,146381,58535,6.3,30.99243778,31.11388766,12.15634707,25.73732749,886,880,1412,8322,7,6,1419,2.563405104,2.596448571,South Carolina,South
45085,40230,56937,6.5,33.75327178,32.21157995,10.87669342,23.15845486,348,339,-110,2525,9,9,-101,2.615405624,2.644515235,South Carolina,South
45091,134794,83692,5.8,30.85949048,23.56794063,7.460267297,38.11230159,694,598,1950,3936,12,96,1962,2.553063572,2.604899491,South Carolina,South
46011,17783,71166,3.9,29.68873025,23.06440607,3.280667681,43.966196,90,56,-66,3196,5,34,-61,2.5826381,2.67216098,South Dakota,Midwest
46013,19766,71731,4,30.10693069,30.38811881,6.336633663,33.16831683,99,100,-76,1155,4,-1,-72,2.444763764,2.477220575,South Dakota,Midwest
46027,6862,55263,4.1,22.01053912,25.94244021,6.093771112,45.95324956,25,20,23,2531,0,5,23,2.601861825,2.677425325,South Dakota,Midwest
46035,10528,63753,3.7,31.92247717,34.88527512,8.23494468,24.95730304,63,37,-20,518,0,26,-20,2.424354626,2.537977236,South Dakota,Midwest
46065,9583,79301,3,32.77208394,27.38734342,3.896209533,35.9443631,63,52,-40,775,0,11,-40,2.628095112,2.656039726,South Dakota,Midwest
46081,12799,67606,5.7,33.59810626,27.67490794,4.639663335,34.08732246,57,57,73,1031,2,0,75,2.53317077,2.627948049,South Dakota,Midwest
46099,108738,75623,4.1,33.07348994,25.41916709,6.941889569,34.56545339,729,448,116,5207,33,281,149,2.501675691,2.59382012,South Dakota,Midwest
46103,54642,67573,4.8,33.56140599,27.06519363,5.318122773,34.05527761,354,259,244,3923,7,95,251,2.525219328,2.649869425,South Dakota,Midwest
46135,11260,62951,4.1,31.50617888,33.57396305,7.267833109,27.65202496,66,65,-27,1872,0,1,-27,2.952859467,3.120322877,South Dakota,Midwest
47001,32012,64615,6.7,31.78831659,33.20980361,8.661403226,26.34047657,206,256,224,1117,0,-50,224,2.574534219,2.648657233,Tennessee,South
47003,19363,70185,8,26.65241456,41.20127683,15.23706329,16.90924532,174,123,89,1028,0,51,89,2.654147643,2.725350854,Tennessee,South
47009,59667,69713,6.4,28.49555929,35.41266603,9.302488398,26.78928629,318,410,474,2160,0,-92,474,2.558462983,2.631094156,Tennessee,South
47011,49109,62666,6.6,32.92049965,30.84305683,11.59651149,24.63993204,271,312,236,2564,0,-41,236,2.511482472,2.579929961,Tennessee,South
47019,22058,48912,6.8,30.13035914,37.86849694,11.34386692,20.657277,120,207,106,1458,0,-87,106,2.459245691,2.443345868,Tennessee,South
47021,20146,78437,5.7,28.47301952,36.7967853,9.674478287,25.05571689,105,121,77,349,0,-16,77,2.131387156,2.215745917,Tennessee,South
47025,11831,41087,7.4,25.89262557,39.9239215,16.87991701,17.30353592,65,108,72,1362,0,-43,72,2.674950013,2.516850883,Tennessee,South
47029,13323,45361,10.3,24.62345702,47.38590465,16.34517383,11.6454645,82,147,115,316,0,-65,115,2.623563542,2.774515593,Tennessee,South
47031,23629,56519,7.9,26.61467706,37.88742252,12.5624875,22.93541292,180,178,262,737,1,2,263,2.468099697,2.532457639,Tennessee,South
47035,21064,53388,7.5,31.34571723,39.80598555,10.35294118,18.49535604,132,218,354,601,0,-86,354,2.633001921,2.663682816,Tennessee,South
47037,366443,72561,8.2,22.91636257,20.10310741,9.659984755,47.32054526,2367,1559,-913,24848,106,808,-807,2.563376303,2.614701357,Tennessee,South
47043,24769,70192,6,28.82595503,39.01812806,10.79903524,21.35688166,148,159,146,763,0,-11,146,2.580699293,2.617961523,Tennessee,South
47045,14649,53715,7.9,26.88176337,40.63410933,10.84135287,21.64277443,109,126,-74,492,0,-17,-74,2.422975307,2.567111396,Tennessee,South
47047,18002,84328,6.2,31.0243506,32.97177331,9.105685974,26.89819012,84,121,208,536,0,-37,208,2.491841044,2.560823003,Tennessee,South
47051,18297,61417,8,27.29790144,40.48977413,9.161578754,23.05074567,95,120,96,2095,0,-25,96,2.431858946,2.714859858,Tennessee,South
47053,20319,55608,6.8,27.93075404,41.34715929,11.641687,19.08039967,117,155,54,939,0,-38,54,2.589996482,2.647571784,Tennessee,South
47059,26539,50410,8.1,26.11118689,42.90418753,13.30501374,17.67961184,170,217,240,2133,0,-47,240,2.517111078,2.582070977,Tennessee,South
47063,25951,56734,7.1,28.3403276,38.74148279,12.86043049,20.05775913,168,222,78,578,1,-54,79,2.54666331,2.628934607,Tennessee,South
47065,170053,75127,7.1,30.82071287,23.34748356,8.86683494,36.96496864,1054,997,988,8883,10,57,998,2.558642296,2.619663187,Tennessee,South
47073,21589,52819,7.7,26.742586,42.87544484,13.59667853,16.78529063,118,187,57,528,0,-69,57,2.499010514,2.640957197,Tennessee,South
47083,2993,60581,7.8,27.68995411,45.96294408,12.663607,13.68349482,14,26,31,182,0,-12,31,2.118347482,1.778491498,Tennessee,South
47089,23063,60785,7.5,31.47134899,36.43056108,11.06744926,21.03064067,127,167,292,1722,0,-40,292,2.572576555,2.593327433,Tennessee,South
47093,228861,70013,5.9,27.54665035,24.62434995,7.667482411,40.16151728,1302,1226,1474,13996,9,76,1483,2.537582071,2.603688794,Tennessee,South
47103,14623,61591,8.4,24.41593952,43.28280188,13.02424705,19.27701154,83,127,47,285,1,-44,48,2.609453401,2.487844567,Tennessee,South
47105,22225,79683,6.2,29.58599401,30.77593723,11.0841443,28.55392446,114,164,317,483,3,-50,320,2.545742976,2.612920704,Tennessee,South
47107,21495,60950,7.8,29.70677399,38.96874347,13.8223918,17.50209074,136,205,143,1040,1,-69,144,2.47173382,2.59399958,Tennessee,South
47113,45677,57070,7.5,29.62257072,34.7400015,9.687101373,25.95032641,265,310,9,4379,0,-45,9,2.573904723,2.603402675,Tennessee,South
47117,14064,64013,9.1,32.42547538,37.10039027,9.482687038,20.99144731,102,80,130,311,0,22,130,2.481946096,2.580698464,Tennessee,South
47119,46948,70225,8.1,32.0873979,33.97135078,7.470139963,26.47111135,353,225,798,1289,0,128,798,2.522185396,2.592120875,Tennessee,South
47123,18535,56047,8,29.65962441,40.86267606,13.67664319,15.80105634,122,155,192,442,0,-33,192,2.808843666,2.767483846,Tennessee,South
47125,80370,67478,7.6,35.35751121,27.26851754,5.653665621,31.72030563,918,396,765,4730,5,522,770,2.61380585,2.659429147,Tennessee,South
47141,32815,54996,6.5,26.41581584,33.14404803,11.24622385,29.19391228,200,238,256,3077,0,-38,256,2.539315448,2.581484575,Tennessee,South
47143,11853,59207,9.6,25.33971787,41.37008757,15.90526724,17.38492731,91,104,74,463,0,-13,74,2.454362739,2.568794141,Tennessee,South
47145,21506,63430,6.3,29.83404949,37.44752309,10.67812515,22.04030227,111,210,234,404,0,-99,234,2.633037058,2.748874143,Tennessee,South
47147,34926,77326,6.1,28.15232556,39.61604213,11.14538917,21.08624315,213,208,130,798,0,5,130,2.51883508,2.64044282,Tennessee,South
47149,173735,77320,7,29.87720775,28.10473614,7.629509548,34.38854656,989,644,1460,5739,15,345,1475,2.584190775,2.623727641,Tennessee,South
47155,48806,59530,9.7,31.0667982,35.29171364,12.20264938,21.43883878,242,280,207,667,2,-38,209,2.514678261,2.590657741,Tennessee,South
47157,404536,61452,9.6,28.19174267,27.44214021,10.16832687,34.19779025,3017,2397,-1112,13984,40,620,-1072,2.593675005,2.627278394,Tennessee,South
47163,64328,54361,7.1,30.3844578,32.6328189,10.36516662,26.61755668,369,594,298,2269,0,-225,298,2.55351236,2.643709078,Tennessee,South
47165,96677,87453,6.5,30.18635154,28.98657374,8.201487638,32.62558708,546,469,1115,1643,2,77,1117,2.509440114,2.598875986,Tennessee,South
47167,25776,68778,6.7,34.41189855,36.36624913,10.74653318,18.47531914,157,159,48,843,0,-2,48,2.528775865,2.588114061,Tennessee,South
47179,56488,64270,6.3,28.245805,29.36878294,8.860964123,33.52444794,296,414,324,5336,2,-118,326,2.544591568,2.600218379,Tennessee,South
47183,14577,49815,5.7,20.94972067,45.39816305,12.03957959,21.61253669,72,93,11,2092,0,-21,11,2.466769927,2.526520529,Tennessee,South
47187,123273,133486,4.7,20.88354612,13.2120272,4.068726882,61.8356998,563,378,1696,1361,6,185,1702,2.521452208,2.584458104,Tennessee,South
47189,72940,88462,6.3,27.54325325,28.78040949,6.454933515,37.22140375,390,360,943,1855,1,30,944,2.512710633,2.641436594,Tennessee,South
48001,21676,60800,5.7,33.40199765,38.04642027,14.01470694,14.53687513,135,171,23,13908,1,-36,24,2.612724839,2.663770358,Texas,South
48003,8420,68998,8.2,24.69591855,32.22812866,23.12820975,19.94774304,66,28,-37,68,0,38,-37,2.838666298,2.90973615,Texas,South
48005,32661,56825,7.6,32.79665337,34.06921765,15.12136818,18.0127608,265,294,-5,2523,0,-29,-5,2.686592687,2.713633277,Texas,South
48007,8383,60523,8.4,31.79238898,32.02665417,8.553282316,27.62767453,38,98,184,433,0,-60,184,2.618589547,2.703899832,Texas,South
48013,19743,59817,8.6,26.94793091,38.66347707,19.12203306,15.26655897,171,121,93,346,0,50,93,2.759197016,2.796990273,Texas,South
48021,40074,73403,6,28.71774169,29.79875004,18.13791454,23.34559373,283,201,811,2174,1,82,812,2.634053847,2.698231775,Texas,South
48025,8825,48176,9.9,33.19376599,36.92486625,18.43219353,11.44917423,85,84,-24,7406,0,1,-24,2.827723516,2.826731015,Texas,South
48027,134302,62412,7,37.73016104,26.10045412,8.991353727,27.17803111,1483,680,696,8730,16,803,712,2.639742817,2.670306596,Texas,South
48029,861055,65839,7.6,30.42573381,24.46159548,13.57302516,31.53964555,6018,3560,3147,38563,117,2458,3264,2.672535908,2.692456638,Texas,South
48037,35745,52460,7.4,31.93306941,36.00884715,9.986697226,22.07138621,284,284,-6,5675,1,0,-5,2.595495173,2.637323084,Texas,South
48039,162907,86197,8.6,32.2819668,24.80779332,10.81888799,32.09135189,1052,701,1036,10342,15,351,1051,2.656681407,2.682718977,Texas,South
48041,110672,60355,5.3,25.02472956,21.44309828,10.99495913,42.53721304,654,335,216,20800,20,319,236,2.597979723,2.640531591,Texas,South
48043,3818,52388,6.6,27.74832589,16.95033482,10.03069196,45.27064732,12,20,27,505,0,-8,27,2.749203683,2.74773551,Texas,South
48049,14213,53455,6.5,32.28007047,35.52606919,12.25683122,19.93702912,95,140,-11,1709,0,-45,-11,2.736167719,2.777832251,Texas,South
48053,22510,74897,4.8,30.23761032,30.26748133,10.79972845,28.6951799,119,146,427,974,0,-27,427,2.355902633,2.442449123,Texas,South
48055,17680,60833,6.5,25.45045045,38.44372542,19.68024362,16.42558051,129,135,60,2431,1,-6,61,2.748373243,2.66810331,Texas,South
48061,152951,49583,10.1,25.0206636,26.06328964,28.35793285,20.55811391,1473,799,-329,4265,26,674,-303,2.668304634,2.688108557,Texas,South
48067,11227,54276,7.9,28.37048044,41.31253096,12.7191679,17.5978207,77,104,13,358,0,-27,13,2.602639559,2.65576734,Texas,South
48071,18407,102146,9.4,39.96549741,26.56379784,10.50412114,22.9665836,116,97,465,223,0,19,465,2.697678001,2.698911699,Texas,South
48073,19412,50351,7.9,28.96517237,33.27156136,19.30521238,18.45805389,165,150,54,2168,0,15,54,2.736854443,2.700358897,Texas,South
48083,2648,45834,7.4,37.23497459,33.4326266,11.40704398,17.92535483,23,30,8,33,0,-7,8,2.663161125,2.676885603,Texas,South
48085,542541,113943,6.3,25.14695588,14.412217,5.527433116,54.913394,2786,1301,8062,8803,150,1485,8212,2.577064745,2.649002418,Texas,South
48091,72493,92979,6.1,30.27401272,21.71681013,5.795108775,42.21406837,389,355,2377,1517,3,34,2380,2.661863472,2.69014018,Texas,South
48097,17844,66466,7.1,33.57570276,31.22042861,11.60937935,23.59448928,110,104,69,639,0,6,69,2.680126708,2.717884209,Texas,South
48099,22179,63428,6.6,41.75323458,30.24751547,9.343708982,18.65554097,229,146,-63,12802,2,83,-61,2.638905661,2.681571554,Texas,South
48113,1225658,70871,7.8,24.34592246,22.48805467,18.31877728,34.84724559,8665,4852,-5975,29705,299,3813,-5676,2.621503222,2.638930139,Texas,South
48117,8166,55565,3.6,18.60897019,40.97873526,28.59132696,11.82096759,87,44,-91,160,0,43,-91,2.537218866,2.604622746,Texas,South
48121,478345,102711,6.4,28.26533067,16.75276091,6.589551382,48.39235703,2468,1113,7024,9389,65,1355,7089,2.612839655,2.666896795,Texas,South
48123,8618,55525,6.1,28.84309472,40.83152567,14.57700651,15.7483731,55,65,22,1536,0,-10,22,2.644464249,2.689148591,Texas,South
48131,4236,40539,12.2,31.70284317,34.89758484,26.42922654,6.97034546,24,28,-14,599,0,-4,-14,2.750373854,2.732307885,Texas,South
48133,6824,53351,6.8,29.44896116,33.30869672,15.0283321,22.21401002,53,63,55,791,0,-10,55,3.053954538,2.964410508,Texas,South
48135,73412,64868,11.1,30.50811164,30.4703831,22.37404277,16.6474625,667,327,-91,2547,7,340,-84,2.765927569,2.752937154,Texas,South
48139,89362,89314,6,32.08361133,26.96139383,12.35367259,28.60132225,558,399,1840,1781,1,159,1841,2.629101083,2.651280279,Texas,South
48141,331382,53441,8.3,30.39289209,24.89336102,19.3525563,25.3611906,2686,1545,-488,16003,1,1141,-487,2.692124336,2.699193381,Texas,South
48143,18776,60093,5.7,28.29239766,26.27290448,12.93957115,32.49512671,105,87,157,3758,0,18,157,2.653574131,2.637500693,Texas,South
48157,371808,105583,7.6,25.0454503,17.59501448,8.067697592,49.29183763,2185,1045,5171,4693,167,1140,5338,2.623157997,2.664377572,Texas,South
48163,8975,46769,5.7,18.47105612,40.7158639,29.4211224,11.39195758,51,35,3,3581,0,16,3,2.797635516,2.767571971,Texas,South
48167,149429,75947,8.8,32.45897687,23.12839781,10.15436666,34.25825866,918,823,749,4923,2,95,751,2.615176209,2.649250348,Texas,South
48179,7114,50648,8.1,33.21846507,36.14042645,15.24158231,15.39952617,67,59,-42,1535,0,8,-42,2.578625445,2.575241835,Texas,South
48181,60126,66141,5.9,35.63374024,31.09780608,9.535193687,23.73325999,405,396,562,2074,0,9,562,2.578267534,2.642243986,Texas,South
48183,51574,60932,8.3,36.11207581,28.28562215,13.24419528,22.35810677,388,375,-38,3375,1,13,-37,2.618947543,2.634852207,Texas,South
48187,75621,86043,6.1,29.76721646,28.61165422,10.69835063,30.9227787,445,303,865,1776,0,142,865,2.683601353,2.701800348,Texas,South
48189,10904,49571,6.8,26.18666133,33.30162227,24.87983176,15.63188464,107,69,-95,1907,0,38,-95,2.777442132,2.762857974,Texas,South
48191,1001,40677,5.8,30.91528724,34.56669912,16.69912366,17.81888997,1,10,-10,34,0,-9,-10,2.633926949,2.946768836,Texas,South
48199,22932,70432,8.9,31.83310498,37.30579324,10.09487372,20.76622806,160,169,114,390,0,-9,114,2.684035287,2.654443278,Texas,South
48201,2070430,68748,9,26.01538523,22.71939693,17.51866872,33.74654912,15208,7772,-5693,48010,527,7436,-5166,2.663798031,2.673003913,Texas,South
48203,26683,64636,7.9,34.17237257,32.47907836,10.8466471,22.50190197,165,194,-17,2022,0,-29,-17,2.636356049,2.649849102,Texas,South
48209,115559,89074,6.3,28.36707,21.24216266,8.513325041,41.8774423,686,307,2772,7873,7,379,2779,2.669219282,2.689659197,Texas,South
48213,34602,62843,6.4,33.74316017,33.56583125,12.47888941,20.21211917,212,299,368,1149,0,-87,368,2.636402228,2.682029646,Texas,South
48215,317207,48825,11.7,23.85568854,25.16626495,30.65137957,20.32666694,3107,1113,-198,7929,-17,1994,-215,2.655495647,2.660194393,Texas,South
48217,15208,57566,6.3,34.30688927,34.16743037,13.07327569,18.45240467,77,112,136,488,0,-35,136,2.525017329,2.721063582,Texas,South
48219,9790,56923,8,33.12157722,28.45564074,20.10952903,18.31325301,65,63,-37,305,0,2,-37,2.493855296,2.475528858,Texas,South
48221,26073,75545,6.6,31.95045644,27.90254146,7.740110573,32.40689153,150,188,555,913,0,-38,555,2.576998349,2.659913362,Texas,South
48223,16531,64249,5.1,30.56029184,34.04575915,15.3653991,20.0285499,111,105,22,452,0,6,22,2.595025072,2.623100801,Texas,South
48225,9524,49741,5.3,29.39156035,37.75147203,17.33316977,15.52379784,52,92,29,2699,0,-40,29,2.612074515,2.524409843,Texas,South
48227,12319,59598,8.1,32.72415762,33.15907394,18.776084,15.34068444,104,98,-65,4934,0,6,-65,2.73030474,2.716417916,Texas,South
48231,40313,68019,6.6,30.84840337,33.57618862,13.68229325,21.89311476,279,296,315,2980,1,-17,316,2.609039996,2.626204673,Texas,South
48241,11376,50763,11.2,29.70088286,46.08424474,11.6616155,12.55325691,87,120,-31,793,0,-33,-31,2.56552033,2.61803724,Texas,South
48245,92024,55065,12,33.04598718,32.38810021,15.11605952,19.44985308,748,716,-444,13734,0,32,-444,2.637832335,2.653401163,Texas,South
48249,13989,48252,13,26.73627975,37.29156548,20.79488425,15.17727052,132,96,-54,334,0,36,-54,2.753563073,2.708068404,Texas,South
48251,77847,76747,6.5,29.34912009,34.0316977,13.07752735,23.54165486,491,378,865,3360,0,113,865,2.656345146,2.680282766,Texas,South
48257,64784,92814,6.4,31.9991318,29.04034176,13.66331554,25.2972109,467,288,1797,1523,1,179,1798,2.642321004,2.665297906,Texas,South
48259,21003,120238,5.1,27.88547203,16.55248687,6.442198396,49.11984271,89,110,305,835,1,-21,306,2.596891058,2.610263044,Texas,South
48265,20377,59619,5.9,30.04351165,29.06066035,9.682620937,31.21320706,107,191,203,1932,1,-84,204,2.506094137,2.578932695,Texas,South
48273,12090,51342,8.5,27.28005992,32.82249237,16.17214957,23.72529815,86,61,-78,1317,1,25,-77,2.69848267,2.682836907,Texas,South
48277,21983,62620,6.4,33.62940097,33.81869012,11.96889834,20.58301057,145,165,61,668,0,-20,61,2.640208571,2.719278132,Texas,South
48291,30712,61880,10.5,28.67551091,38.16517702,21.92172347,11.23758859,293,187,770,4913,1,106,771,2.758304436,2.770709694,Texas,South
48293,7700,51357,7.1,35.03278899,31.39385367,14.44644464,19.12691269,59,71,2,1138,0,-12,2,2.663950086,2.689725131,Texas,South
48303,147580,59138,5.8,29.94030373,25.54968775,11.18550339,33.32450514,981,747,628,11395,17,234,645,2.602126984,2.630418959,Texas,South
48309,111569,63160,6.2,33.02103828,27.30227653,11.90504092,27.77164427,773,604,367,10114,2,169,369,2.58260576,2.630256196,Texas,South
48321,14720,58380,10.5,31.1388935,28.83784682,17.25369663,22.76956305,135,97,-15,358,2,38,-13,2.667140815,2.693498365,Texas,South
48323,20559,43407,15.1,24.04486295,28.35422539,32.27373598,15.32717567,244,116,-137,468,1,128,-136,2.671120858,2.687144165,Texas,South
48325,19948,70313,6.3,31.19232603,32.603147,14.0465038,22.15802317,121,107,193,2143,0,14,193,2.752232387,2.713590494,Texas,South
48329,90423,81187,8.1,31.78729772,23.50841644,13.76095625,30.94332958,728,275,-139,1770,6,453,-133,2.682623808,2.686320156,Texas,South
48331,8970,54667,7.2,27.2523815,39.95179617,13.27900838,19.51681396,77,68,11,360,0,9,11,2.842129503,2.731655942,Texas,South
48339,267945,95241,7.5,28.95582189,23.30899053,9.840082929,37.89510465,1833,1198,4410,4163,36,635,4446,2.610171323,2.655970014,Texas,South
48347,25955,51708,6.6,29.51974049,29.12677691,14.84822111,26.50526149,196,184,-55,4289,0,12,-55,2.614775859,2.630676035,Texas,South
48349,21818,50822,6.2,33.22102426,29.05777569,20.64924411,17.07195594,145,125,198,1261,0,20,198,2.629365223,2.633340124,Texas,South
48355,149531,60250,8.9,32.33157652,29.24673591,14.73673403,23.68495354,1041,769,-156,7576,3,272,-153,2.700889416,2.704236739,Texas,South
48361,31878,63901,10.6,36.45323677,36.73938002,9.01351232,17.79387088,249,274,-45,526,0,-25,-45,2.633839523,2.674656513,Texas,South
48363,12222,56809,7,31.65008542,35.81549593,13.85790373,18.67651492,80,115,72,269,0,-35,72,2.611551457,2.694387996,Texas,South
48365,8596,59772,8.4,36.55837432,30.61092415,14.95599275,17.87470878,77,106,28,338,0,-29,28,2.582580752,2.61068332,Texas,South
48367,65376,95277,5.8,32.9727609,25.96401749,9.481373538,31.58184807,385,331,1381,1383,2,54,1383,2.605136043,2.632568014,Texas,South
48371,5865,54003,8.3,26.24309392,39.39423836,20.94514601,13.4175217,52,33,-32,1818,0,19,-32,2.936395491,2.824502391,Texas,South
48373,16708,58894,8.8,29.79013501,38.58842401,18.21414249,13.40729849,104,203,538,3810,0,-99,538,2.70145816,2.738935559,Texas,South
48375,50128,51028,5.5,29.38379102,30.6845278,22.5961152,17.33556597,395,335,-310,7190,2,60,-308,2.579103387,2.620784897,Texas,South
48377,2717,43666,14.9,23.95417,21.90247802,33.94617639,20.19717559,14,6,-29,46,0,8,-29,2.387962648,2.632556327,Texas,South
48381,69640,77066,4.5,37.76611379,23.82951921,6.35208902,32.05227798,406,288,468,2575,0,118,468,2.711034877,2.728685328,Texas,South
48389,8153,53969,7.2,24.28298279,40.10516252,28.74043977,6.871414914,56,29,-6,3091,0,27,-6,2.908652554,2.868975789,Texas,South
48397,51302,124291,5.9,31.27912456,18.93947327,5.80920467,43.9721975,270,165,1299,662,2,105,1301,2.56485898,2.645081421,Texas,South
48401,20299,55085,7.4,34.17016111,32.84595012,15.12359303,17.86029574,164,150,7,5041,0,14,7,2.688533817,2.713700218,Texas,South
48409,26353,62919,10.2,31.85411269,34.7898643,16.11479513,17.24122788,206,156,12,359,0,50,12,2.727688646,2.718944923,Texas,South
48423,100705,67978,6.8,35.38970523,24.86760055,12.00167642,27.74101779,712,624,604,5534,2,88,606,2.646104488,2.67402708,Texas,South
48427,21481,35758,17.5,21.66689364,25.10962822,39.92646057,13.29701757,212,102,-165,304,0,110,-165,2.797388308,2.764517037,Texas,South
48439,995932,76285,7.4,28.95990334,23.61187912,12.88021611,34.54800144,6339,3793,1659,27114,203,2546,1862,2.62927113,2.673878508,Texas,South
48441,62293,61798,5.5,32.20704448,29.34861142,9.434409573,29.00993452,433,327,96,5918,2,106,98,2.611258404,2.655268824,Texas,South
48449,12328,58411,6.7,26.43032284,35.2778913,22.8902738,15.40151206,109,73,2,246,0,36,2,2.873045712,2.781575463,Texas,South
48451,50179,60348,6.3,34.29921461,27.74152353,12.84209182,25.11717004,364,271,39,3499,14,93,53,2.689919279,2.700847168,Texas,South
48453,687548,95151,6.4,21.65817507,14.36494028,8.462116212,55.51476844,3627,1740,4560,33361,144,1887,4704,2.593355721,2.667335255,Texas,South
48463,10541,48427,6.4,32.19628579,25.90920815,21.73071963,20.16378643,94,71,-33,846,2,23,-31,2.764254727,2.76887198,Texas,South
48465,19672,52593,8.3,23.9435648,29.79405982,24.93014592,21.33222947,190,103,-76,1953,1,87,-75,2.671033477,2.682113166,Texas,South
48467,24405,57706,6.2,36.56133437,32.55213832,12.68679475,18.19973256,151,174,247,574,0,-23,247,2.65115209,2.741078518,Texas,South
48469,37401,67905,8.3,34.37270849,30.99460036,14.94567029,19.68702087,282,233,-82,1188,0,49,-82,2.67821078,2.707609451,Texas,South
48471,22258,53301,7.2,28.66903317,34.66162831,15.23722279,21.43211573,155,159,124,18877,3,-4,127,2.666742148,2.668643672,Texas,South
48473,22518,75223,7.6,28.117338,29.25277291,16.0566258,26.57326328,180,102,492,6257,0,78,492,2.630631612,2.603179167,Texas,South
48477,14320,66911,5.7,31.05915837,28.32282984,9.615775564,31.00223623,76,132,51,2046,0,-56,51,2.613661887,2.677389856,Texas,South
48479,105964,56289,8.5,26.68486606,22.16214088,30.21143675,20.94155631,1020,379,-461,3976,32,641,-429,2.675326895,2.682255703,Texas,South
48481,19822,57487,6.8,33.37442889,31.34382479,16.05627674,19.22546958,141,122,-34,552,0,19,-34,2.67504972,2.688718891,Texas,South
48485,51659,56634,6.6,31.94887798,31.25327553,11.9622183,24.83562819,357,322,172,11193,22,35,194,2.621893184,2.691515316,Texas,South
48489,5795,41648,12,20.92969294,34.61984686,32.26854358,12.18191662,46,52,-17,2594,0,-6,-17,2.670543842,2.633224829,Texas,South
48491,304159,101891,5.8,29.00894535,17.74845194,5.840286875,47.40231583,1625,927,6350,4492,37,698,6387,2.577850642,2.65190408,Texas,South
48493,22973,79432,5.7,32.93638447,30.39911747,10.3923288,26.27216926,133,97,275,426,0,36,275,2.84104654,2.840150494,Texas,South
48497,29988,80096,6.6,32.30172502,33.69807084,13.36123303,20.63897111,195,172,305,802,0,23,305,2.555347343,2.610344214,Texas,South
48499,16633,57504,6.6,32.94528866,31.51752125,13.27645961,22.26073047,92,165,288,1342,1,-73,289,2.644796761,2.665356094,Texas,South
48505,4093,39403,12.2,21.53826788,29.24219537,35.93907351,13.28046324,47,29,-31,113,0,18,-31,2.710724097,2.666954794,Texas,South
48507,2904,36237,14.3,30.80967403,33.01787592,26.6211006,9.551349457,38,36,-10,43,0,2,-10,2.702593675,2.680222971,Texas,South
49003,25502,79450,4.5,33.92155223,31.94502523,7.421036492,26.71238605,226,128,176,340,0,98,176,2.579917956,2.691707371,Utah,West
49005,64038,76631,3,33.43453457,20.13245594,6.008529146,40.42448034,543,137,22,4152,-1,406,21,2.513485902,2.587118693,Utah,West
49011,169150,103143,4.2,36.24381081,21.09887204,3.96792107,38.68939608,1295,535,161,2336,8,760,169,2.57949942,2.668503996,Utah,West
49021,24156,66499,4.6,37.89306791,24.96843712,6.832261664,30.3062333,226,87,302,1648,0,139,302,2.599058224,2.684773516,Utah,West
49035,611284,91713,5.2,30.90411203,22.17460072,8.291081635,38.63020561,3838,1829,-870,18047,100,2009,-770,2.584084571,2.671393002,Utah,West
49043,22866,132358,7.4,22.63461074,14.30788866,4.98775482,58.06974578,109,48,48,133,0,61,48,2.509936241,2.643410822,Utah,West
49045,34394,91353,4.8,38.60714915,30.91433351,7.276809297,23.20170805,268,101,500,515,0,167,500,2.62683169,2.664463103,Utah,West
49049,304982,95085,3.9,34.78572493,16.75926882,4.618639694,43.83636656,3049,699,1738,15951,13,2350,1751,2.534001837,2.6130541,Utah,West
49053,75839,75572,5.5,39.57189376,21.46117993,5.679351296,33.28757502,533,416,1791,2776,0,117,1791,2.568632936,2.634177346,Utah,West
49057,123855,83465,4.9,35.76273907,28.53456835,7.65325232,28.04944026,906,495,290,3682,0,411,290,2.590458942,2.658414947,Utah,West
50007,91326,86579,4.7,22.42589498,17.27680535,4.499076436,55.79822324,349,332,-29,9871,19,17,-10,2.531857663,2.627889779,Vermont,Northeast
50021,28158,61290,6.7,27.29451447,32.89987573,6.271081129,33.53452867,114,189,-27,1876,0,-75,-27,2.632677673,2.692637711,Vermont,Northeast
50023,32218,77432,4.9,23.39907087,25.3256513,4.269903443,47.00537439,111,160,-13,2323,0,-49,-13,2.57899994,2.640632734,Vermont,Northeast
50025,20154,61976,6.7,23.89587599,28.56683241,5.182801989,42.35448962,68,112,-18,1812,0,-44,-18,2.531373465,2.696106025,Vermont,Northeast
50027,27198,74244,5.9,24.62747779,28.35725678,5.103668262,41.91159717,116,155,31,742,1,-39,32,2.533338448,2.596706919,Vermont,Northeast
51013,144218,131020,4.6,11.19225063,7.123600824,4.574921923,77.10922662,699,360,-323,2982,50,339,-273,2.530813075,2.607845836,Virginia,South
51041,175462,100149,6.1,28.33966735,21.88533584,7.111849637,42.66314718,984,786,962,5285,19,198,981,2.570190252,2.622719877,Virginia,South
51047,23398,94287,5.1,29.07978871,32.61050876,11.90436475,26.40533778,173,126,167,1430,2,47,169,2.703121725,2.742046487,Virginia,South
51059,585189,144632,6,17.0140985,11.95035596,6.768552834,64.2669927,3141,1862,-3198,11415,325,1279,-2873,2.554824949,2.636928588,Virginia,South
51061,34677,120301,4.9,27.44040472,24.78297671,8.100234247,39.67638432,190,160,-6,399,0,30,-6,2.531988488,2.624801921,Virginia,South
51067,24463,68089,5.6,31.98363396,34.25891276,9.430431854,24.32702143,119,168,61,1229,0,-49,61,2.821142873,2.730313057,Virginia,South
51085,54660,103639,5,27.60584335,24.37507214,5.654811528,42.36427298,264,270,198,2067,1,-6,199,2.532613316,2.603048517,Virginia,South
51087,167858,82187,6.7,25.47770972,21.8002945,6.980516016,45.74147976,886,878,-171,4586,48,8,-123,2.564795661,2.6374388,Virginia,South
51093,18218,85227,5.2,31.84260765,30.38959202,7.823658347,29.94414198,84,90,95,199,2,-6,97,2.695059476,2.663717443,Virginia,South
51107,212910,167605,5.5,18.46031752,11.65965821,5.86627788,64.0137464,1183,511,885,1236,66,672,951,2.548329697,2.6317216,Virginia,South
51121,46258,69668,4.9,23.51506737,23.75536213,4.334205514,48.39536498,182,167,-179,10913,17,15,-162,2.513356004,2.596073269,Virginia,South
51147,9391,57400,6.7,27.81733746,35.96749226,12.0123839,24.20278638,74,67,46,4405,0,7,46,2.666619582,2.656446941,Virginia,South
51153,229125,119051,6.7,25.57457291,20.16827692,9.779576428,44.47757374,1530,730,-388,2982,92,800,-296,2.61069905,2.681414064,Virginia,South
51165,39391,72921,4.9,22.52028738,36.09689702,12.98392516,28.39889044,210,249,30,2270,2,-39,32,2.630843299,2.679595643,Virginia,South
51191,24208,61686,6,29.24408941,34.34716813,9.881167977,26.52757449,114,177,8,1959,0,-63,8,2.526275866,2.560530893,Virginia,South
51195,12005,45220,7.8,30.5682434,34.14879616,19.67562127,15.60733917,84,124,-20,2651,0,-40,-20,2.493111218,2.573793028,Virginia,South
51199,30655,111346,5.7,29.00300225,16.66041198,4.313651906,50.02293387,154,122,120,1031,4,32,124,2.560219597,2.617789906,Virginia,South
51510,92409,110115,6.2,16.4665725,10.63525693,7.143697875,65.75447269,610,245,-740,1382,37,365,-703,2.552662351,2.624274809,Virginia,South
51520,6913,43123,7.8,30.92277487,34.71040576,10.4466623,23.92015707,53,61,94,296,0,-8,94,2.57577584,2.652315004,Virginia,South
51540,23385,67903,6.7,17.43409732,14.65345172,7.361139789,60.55131117,133,68,-152,2416,3,65,-149,2.532643581,2.603500546,Virginia,South
51550,114294,87127,6.3,32.87082551,24.14479222,6.563804299,36.42057797,684,529,156,4032,2,155,158,2.603264065,2.664767684,Virginia,South
51590,17198,40799,10,27.71525331,39.0004447,14.98306708,18.30123491,132,168,12,1486,0,-36,12,2.606214419,2.648415275,Virginia,South
51600,11832,122790,6,16.50545253,12.97517097,8.169552092,62.34982441,157,63,-65,323,4,94,-61,2.543716662,2.627531675,Virginia,South
51610,7864,142513,3.9,11.53885221,6.104621635,2.630777044,79.72574911,53,34,2,177,0,19,2,2.532514463,2.617710067,Virginia,South
51630,13031,71217,7.4,26.48104265,19.37796209,7.351895735,46.78909953,73,69,3,2315,2,4,5,2.590265881,2.652625216,Virginia,South
51650,58848,64086,8.8,36.05179732,29.18918919,7.279565848,27.47944764,377,306,10,3646,0,71,10,2.626260202,2.656909546,Virginia,South
51660,22571,56057,6.6,23.14311941,23.36495066,16.74825977,36.74367016,181,102,-183,7321,4,79,-179,2.534447171,2.603299421,Virginia,South
51678,1881,62382,7.2,15.65672101,22.91602584,4.121808674,57.30544448,24,22,0,2700,0,2,0,2.487183919,2.582520165,Virginia,South
51680,32902,50494,7.5,27.95715825,23.93120172,9.576522364,38.53511766,303,199,-149,10655,0,104,-149,2.52253115,2.579049489,Virginia,South
51683,19883,97722,6.8,21.32903833,27.11643563,18.3068515,33.24767454,160,99,-154,67,6,61,-148,2.555430273,2.634154395,Virginia,South
51690,4979,41500,11.3,33.63813007,31.19213624,13.92159104,21.24814264,57,57,-12,488,1,0,-11,2.667351098,2.738793018,Virginia,South
51700,80945,63350,9,32.93260443,29.81123924,8.16024725,29.09590908,653,412,-467,8255,5,241,-462,2.610918384,2.649192664,Virginia,South
51710,100964,60030,9,32.05953047,24.89809358,10.37897995,32.663396,799,531,-564,22280,3,268,-561,2.610761066,2.654975351,Virginia,South
51730,11100,42385,14.7,26.99306192,34.9478553,13.04708295,25.01199983,140,160,-57,528,3,-20,-54,2.598885984,2.626790564,Virginia,South
51740,40274,54843,9.8,34.29733874,31.71957311,10.78471558,23.19837258,293,306,30,2767,5,-13,35,2.629252729,2.652608512,Virginia,South
51750,7924,47892,6.5,33.77501352,19.71335857,6.760411033,39.75121687,41,19,21,3457,0,22,21,2.576657076,2.634702811,Virginia,South
51760,108760,58719,9.1,24.0294474,21.16795577,10.73090423,44.0716926,765,469,67,11643,21,296,88,2.586969721,2.650474871,Virginia,South
51770,45060,50425,7.9,26.782042,33.91455467,10.41129616,28.89210717,333,356,-135,2056,5,-23,-130,2.561437813,2.641845115,Virginia,South
51775,11880,63676,6,34.54671922,28.52422907,5.784836541,31.14421516,84,95,63,2021,0,-11,63,2.610250491,2.601763654,Virginia,South
51790,11358,61917,6.5,29.62159818,28.9656294,6.342838556,35.06993386,87,93,70,1425,0,-6,70,2.561361571,2.631076859,Virginia,South
51800,41988,81858,6.6,33.2879654,26.05782899,8.229743217,32.42446239,256,264,401,1574,1,-8,402,2.583758795,2.634003606,Virginia,South
51810,214201,83066,6.4,32.92426511,21.32839467,5.331862243,40.41547797,1360,859,-426,7309,14,501,-412,2.606695524,2.654167741,Virginia,South
51830,6209,67543,8.4,27.77412136,16.84875609,6.897459523,48.47966302,14,24,69,4878,1,-10,70,2.560322478,2.611126575,Virginia,South
51840,13668,60557,6.1,26.07899132,28.82159599,13.45977693,31.63963576,80,72,-114,1128,0,8,-114,2.568157674,2.648985661,Virginia,South
53005,94278,85144,8.2,33.8537597,23.02777149,10.14320245,32.97526636,638,444,309,1244,6,194,315,2.601367984,2.689682027,Washington,West
53007,40414,81697,8.3,32.2471381,23.37523547,14.1573685,30.22025793,206,177,114,1641,1,29,115,2.611252625,2.660888791,Washington,West
53009,26040,66693,10.2,37.22135993,25.07843202,7.009345794,30.69086226,168,258,324,1781,0,-90,324,2.600412256,2.684403633,Washington,West
53011,224113,91149,8.4,35.29145596,24.5108725,7.237237152,32.96043439,1354,1041,1728,3777,14,313,1742,2.573699733,2.670950797,Washington,West
53015,43888,71847,9.3,41.51589367,31.42190365,10.05552207,17.0066806,296,297,287,937,2,-1,289,2.607937559,2.695903291,Washington,West
53017,19450,83870,8.4,32.31280856,28.36327482,17.46091607,21.86300055,139,83,31,565,0,56,31,2.356366706,2.581433663,Washington,West
53021,38972,77820,8.9,29.49376633,26.69869715,23.39160778,20.41592874,377,133,121,3444,6,244,127,2.640744207,2.711863978,Washington,West
53025,43029,63809,8.8,34.20768201,29.04386262,18.58394231,18.16451306,360,179,101,2213,5,181,106,2.565064393,2.651903234,Washington,West
53027,25442,62258,11.7,37.4654024,35.25472759,9.658756094,17.62111391,171,253,324,2918,0,-82,324,2.604745906,2.716431815,Washington,West
53029,33183,82717,8.2,38.25707857,21.89199325,4.115882243,35.73504594,182,197,173,1690,3,-15,176,2.627250325,2.708702457,Washington,West
53033,1172004,116044,7.8,23.55407523,14.29751363,6.21851814,55.929893,5984,3563,1311,44380,419,2421,1730,2.568721417,2.675755029,Washington,West
53035,118603,93794,7.7,37.73062355,21.05801735,4.686290881,36.52506822,664,554,26,8462,-3,110,23,2.568846323,2.667213957,Washington,West
53037,20380,71737,8.9,30.65309469,27.15193332,6.940838912,35.25413308,91,73,293,1183,0,18,293,2.588106035,2.658463732,Washington,West
53041,31523,67954,9.4,38.64827863,31.56576619,9.635355795,20.15059939,224,229,445,740,1,-5,446,2.519555043,2.623463896,Washington,West
53045,22873,78029,9.9,39.07279398,30.02979871,8.890961059,22.00644625,156,190,387,2473,0,-34,387,2.738472625,2.82146616,Washington,West
53053,406487,92793,9.6,35.60265727,26.71869631,7.530829632,30.14781679,2793,1765,1157,23320,44,1028,1201,2.576592957,2.663221293,Washington,West
53057,56176,79118,9.8,36.17801831,25.5208779,9.166167537,29.13493625,334,325,374,1446,7,9,381,2.569642875,2.666157552,Washington,West
53061,397958,101440,8.8,33.50342019,22.72985152,6.924040173,36.84268811,2409,1551,799,9076,102,858,901,2.572392216,2.676058671,Washington,West
53063,234378,69079,8.7,38.2601479,24.15185591,5.488045775,32.09995042,1514,1194,1503,17411,7,320,1510,2.552405799,2.643981693,Washington,West
53067,132430,88560,8.2,35.1752353,22.11985054,5.529489666,37.17542449,772,597,1050,4746,6,175,1056,2.568785686,2.672919179,Washington,West
53071,27919,66542,6.8,36.21463415,22.93658537,10.76097561,30.08780488,130,151,46,5398,2,-21,48,2.59458767,2.629088073,Washington,West
53073,103131,78796,9.3,34.32200936,21.36003552,6.23194095,38.08601417,522,460,514,6037,7,62,521,2.57203467,2.675886415,Washington,West
53075,20985,54412,5.7,30.85765899,15.05522027,3.929055302,50.15806544,103,58,-189,6537,3,45,-186,2.577932451,2.565529006,Washington,West
53077,118188,63058,9.6,28.19223425,29.25970719,23.68300446,18.86505411,931,682,-328,4032,32,249,-296,2.673486644,2.701525696,Washington,West
54003,54119,70829,6.1,29.29998172,36.92293628,9.428421245,24.34866076,367,350,640,919,3,17,643,2.581689818,2.661233776,West Virginia,South
54011,37874,51017,7.9,27.29452275,30.27289696,9.98423119,32.4483491,251,336,-53,4495,0,-85,-53,2.570723103,2.640701597,West Virginia,South
54019,14326,48710,9.9,24.9793559,44.99724745,13.93132397,16.09207267,107,140,-27,1487,0,-33,-27,2.573592002,2.685395872,West Virginia,South
54029,11621,58077,9.9,29.64543664,40.09004784,10.09286183,20.17165369,45,98,-10,265,0,-53,-10,2.71712009,2.852896717,West Virginia,South
54033,30819,57764,7.8,24.88103914,38.02675012,11.19946843,25.89274232,174,213,-49,920,0,-39,-49,2.579541774,2.614970886,West Virginia,South
54037,27707,87259,5.9,27.774258,28.49310395,10.00779765,33.72484039,161,137,35,1086,0,24,35,2.588209961,2.675049091,West Virginia,South
54039,74524,55160,8.7,25.28207271,36.18965811,9.253842225,29.27442696,411,632,-309,3092,10,-221,-299,2.553683391,2.616681642,West Virginia,South
54045,9669,42615,12,25.22993767,43.57700187,17.35321041,13.83985005,79,126,-17,755,0,-47,-17,2.730438214,2.762609696,West Virginia,South
54049,22606,58855,8.6,27.86643942,38.52391282,7.770374961,25.8392728,151,153,10,1552,0,-2,10,2.616679799,2.625488152,West Virginia,South
54055,18693,43917,9.2,26.47522953,39.46298776,13.39422341,20.6675593,156,245,-52,1178,2,-89,-50,2.549314011,2.613051545,West Virginia,South
54061,50422,59094,6.3,20.68845197,25.41112932,5.963650707,47.93676801,230,174,-30,8149,15,56,-15,2.569700864,2.627236621,West Virginia,South
54069,18426,60241,8.3,28.04617937,32.02424078,7.397501439,32.53207841,94,147,-49,2144,1,-53,-48,2.573783087,2.61572864,West Virginia,South
54079,24688,80034,7.3,28.61154907,36.13027197,6.853567205,28.40461175,119,153,20,316,1,-34,21,2.571673757,2.653566799,West Virginia,South
54081,27258,51317,8.8,25.59682709,38.29227366,14.48402105,21.62687819,175,280,-91,3346,0,-105,-91,2.639577394,2.67085424,West Virginia,South
54099,14165,52540,8.3,30.04764311,37.56226088,14.70800549,17.68209052,89,153,-53,175,3,-64,-50,2.638271092,2.763277443,West Virginia,South
54107,32709,57599,8.7,32.12099028,35.45354718,9.480234261,22.94522827,190,255,-93,1131,0,-65,-93,2.55284973,2.631129241,West Virginia,South
55009,132856,72398,6.2,31.64094076,29.21260579,6.713114439,32.43333902,741,556,-55,7178,7,185,-48,2.516815197,2.591019063,Wisconsin,Midwest
55015,26036,85589,4.8,32.03738419,30.18719265,5.240850925,32.53457223,112,90,1,191,0,22,1,3.154138895,2.995556321,Wisconsin,Midwest
55017,31076,74425,6.4,35.57641821,33.76388801,6.519227942,24.14046584,171,146,-7,2857,0,25,-7,2.333670041,2.545714321,Wisconsin,Midwest
55021,29573,78767,6,36.98943159,31.16014472,6.172046082,25.67837761,143,149,27,1675,0,-6,27,2.522282028,2.653259064,Wisconsin,Midwest
55025,307959,85189,4.9,24.41304307,17.41693704,3.720432569,54.44958731,1483,965,347,17502,60,518,407,2.535541494,2.635066411,Wisconsin,Midwest
55027,45224,69681,5.4,32.26703539,40.26193953,7.549016562,19.92200851,193,239,-16,5960,0,-46,-16,2.414818268,2.670176856,Wisconsin,Midwest
55031,21256,66180,9.3,37.36707119,29.50394095,5.367196297,27.76179157,90,112,76,1372,0,-22,76,2.604383008,2.700381807,Wisconsin,Midwest
55035,55558,70564,5.7,34.20412232,26.14565925,3.991849181,35.65836925,292,212,61,5035,4,80,65,2.53590995,2.640791935,Wisconsin,Midwest
55039,52906,71206,6,33.13506476,37.26444186,6.989652573,22.61084081,252,273,0,3576,2,-21,2,2.566368623,2.61750707,Wisconsin,Midwest
55043,26099,63247,5.3,33.80212492,34.52066572,7.114782288,24.56242707,166,135,-3,4170,0,31,-3,2.565987873,2.678003097,Wisconsin,Midwest
55055,42995,78728,5.6,32.21636504,32.53869657,7.116475842,28.12846255,216,181,-16,4180,0,35,-16,2.45084899,2.566741517,Wisconsin,Midwest
55059,83390,75067,7.2,32.74128453,27.95386542,8.543246817,30.76160323,442,406,-51,4405,5,36,-46,2.597274781,2.66943025,Wisconsin,Midwest
55063,62300,70075,5.5,35.68526751,24.70744545,3.524707445,36.08257959,302,262,59,5368,0,40,59,2.570352022,2.653765732,Wisconsin,Midwest
55071,38265,62910,6.3,32.67210607,37.44348122,7.652558219,22.2318545,186,206,30,1296,0,-20,30,2.516029836,2.59408789,Wisconsin,Midwest
55073,69400,70955,5.1,32.93184337,32.88420311,6.911979453,27.27197407,362,278,-68,1882,0,84,-68,2.516282029,2.606170807,Wisconsin,Midwest
55079,428775,58375,8.4,27.69813685,27.98481188,10.42463435,33.89241692,3054,2654,-1645,21525,119,400,-1526,2.568853915,2.635470079,Wisconsin,Midwest
55087,98119,78808,5.6,31.80983022,30.95976884,5.246746514,31.98365443,542,375,32,3760,0,167,32,2.509481939,2.603904893,Wisconsin,Midwest
55089,46181,97778,5.5,25.84917851,21.61251615,2.173712387,50.36459295,202,217,107,2215,1,-15,108,2.566441626,2.636357159,Wisconsin,Midwest
55093,23192,85508,7.1,32.8545715,30.8305477,4.330896668,31.98398413,89,57,-22,2867,0,32,-22,2.546693146,2.619848237,Wisconsin,Midwest
55097,35783,71360,5.5,30.00564506,31.1172869,5.180424682,33.69664336,152,141,0,3037,2,11,2,2.545820213,2.6565524,Wisconsin,Midwest
55101,91061,72331,7.4,33.71375103,29.88476954,8.415360132,27.9861193,513,551,-169,4516,1,-38,-168,2.611672206,2.656613635,Wisconsin,Midwest
55105,79608,67430,7.3,33.61941586,33.26107538,7.385353164,25.7341556,464,421,-34,3111,0,43,-34,2.594974097,2.664342566,Wisconsin,Midwest
55109,47139,97589,7.2,32.12943568,24.80747905,3.674839823,39.38824544,245,149,230,984,0,96,230,2.497565446,2.579381969,Wisconsin,Midwest
55111,32035,70484,7.7,33.72819438,33.13806446,6.64058278,26.49315838,180,162,-12,989,1,18,-11,2.58726475,2.625440148,Wisconsin,Midwest
55117,58343,65008,5.8,32.57426943,33.64859949,6.458105978,27.3190251,307,295,-21,3187,0,12,-21,2.551962167,2.658666238,Wisconsin,Midwest
55127,53434,73723,6.2,30.94133851,29.25626107,7.485173005,32.31722742,225,241,76,3074,0,-16,76,2.553429992,2.637018845,Wisconsin,Midwest
55131,72277,90313,5.7,32.33723348,28.46630519,4.408047617,34.78841371,273,304,37,906,0,-31,37,2.533401055,2.650192451,Wisconsin,Midwest
55133,211048,99525,5.7,28.64597779,20.55772991,2.859529998,47.9367623,981,933,359,4112,10,48,369,2.518562757,2.597621255,Wisconsin,Midwest
55139,87085,69887,5.6,31.73332191,31.73760384,5.4868545,31.04221975,445,390,-36,7351,1,55,-35,2.525951546,2.636359315,Wisconsin,Midwest
55141,32421,64408,6.8,33.77651036,38.29767143,6.502237918,21.42358029,193,194,-26,1072,0,-1,-26,2.537815317,2.671724796,Wisconsin,Midwest
56001,19784,53537,3.8,26.99251637,14.44340505,3.054256314,55.50982226,87,53,-12,2624,6,34,-6,2.54220324,2.62824294,Wyoming,West
56005,21563,89870,6.9,36.91918044,32.74669611,8.120920869,22.21320258,150,67,14,530,0,83,14,2.616072953,2.661695204,Wyoming,West
56013,17809,55125,6.3,37.06356987,31.21182415,6.470100294,25.25450569,105,122,-24,1269,0,-17,-24,2.789161387,2.950108774,Wyoming,West
56021,47501,71956,5.2,38.23550751,24.19937604,5.524196474,32.04091997,286,231,143,1515,5,55,148,2.612524815,2.71756782,Wyoming,West
56025,36933,70142,7.9,38.10057714,28.28180715,6.247472705,27.370143,239,174,268,1235,0,65,268,2.578627645,2.633561976,Wyoming,West
56029,14365,69802,5.4,36.99995386,23.85456559,4.189544595,34.95593596,59,71,53,657,0,-12,53,2.615942524,2.709881152,Wyoming,West
56037,18973,75779,7.5,41.00813008,31.14724481,7.468834688,20.37579042,113,95,-92,671,1,18,-91,2.651755784,2.687757595,Wyoming,West
56039,14231,127677,5.9,19.79392927,16.14592036,2.840434419,61.21971596,62,17,6,280,2,45,8,2.472876029,2.523730588,Wyoming,West